MT0001,1,1521,1520,,12452
MT0002,2052,3257,1205,,11352
MT0003,3280,4434,1154,,9824
MT0004,4434,4994,560,,9557
MT0005,5207,7264,2057,,9497
MT0006,7302,9815,2513,,9206
MT0007,9914,10825,911,,7559
MT0009,11692,11558,134,,6563
MT0010,12311,11877,434,,6377
MT0011,12468,13013,545,,6377
MT0012,13176,13027,149,,6332
MT0013,13558,13136,422,,6302
MT0014,13995,13717,278,,6298
MT0015,14089,14874,785,,5696
MT0016,14914,15609,695,,5627
MT0017,17470,15593,1877,,5480
MT0018,18762,17470,1292,,5360
MT0019,20234,18762,1472,,5198
MT0020,21640,20234,1406,,5144
MT0021,23172,21640,1532,,4994
MT0022,23737,23273,464,,4874
MT0023,25426,23864,1562,,4871
MT0024,26863,25898,965,,4859
MT0025,26975,27280,305,,4817
MT0026,27577,28344,767,,4805
MT0027,28344,29186,842,,4616
MT0028,29227,29496,269,,4613
MT0029,29703,31046,1343,,4586
MT0030,31170,31484,314,,4538
MT0030.1,31573,31797,224,,4520
MT0031,31948,31808,140,,4472
MT0032,32609,32034,575,,4463
MT0033,32646,33095,449,,4382
MT0034,33168,33494,326,,4241
MT0035,33526,33735,209,,4223
MT0036,34101,33847,254,,4205
MT0037,34239,36551,2312,,4199
MT0038,36551,36811,260,,4193
MT0039,36811,37203,392,,4187
MT0040,37203,38888,1685,,4172
MT0041,39773,39003,770,,4151
MT0042,41122,39824,1298,,3989
MT0043,41248,41853,605,,3980
MT0044,42295,41951,344,,3947
MT0046,43309,42380,929,,3917
MT0047,43506,46412,2906,,3722
MT0048,47151,46528,623,,3701
MT0049,48044,47313,731,,3695
MT0050,48971,48180,791,,3692
MT0051,49883,48990,893,,3650
MT0052,51068,49968,1100,,3625
MT0053,51671,51132,539,,3614
MT0054,52641,51775,866,,3599
MT0055,52775,53185,410,,3584
MT0056,53181,55640,2459,,3554
MT0057,55685,57319,1634,,3551
MT0058,57279,57914,635,,3551
MT0059,58136,58423,287,,3533
MT0060,58530,59021,491,,3503
MT0061,59066,59317,251,,3476
MT0062,59353,59808,455,,3467
MT0063,59840,60358,518,,3440
MT0064,60340,62961,2621,,3437
MT0065,63144,63833,689,,3380
MT0066,63853,64908,1055,,3344
MT0066.1,65336,64959,377,,3338
MT0066.2,65556,65347,209,,3329
MT0067,65496,66635,1139,,3314
MT0068,66867,68303,1436,,3302
MT0069,68362,68520,158,,3293
MT0070,68564,71500,2936,,3293
MT0071,71802,72200,398,,3290
MT0072,74492,72258,2234,,3281
MT0073,75179,74613,566,,3281
MT0074,75282,76190,908,,3281
MT0075,77603,76221,1382,,3275
MT0076,78877,77603,1274,,3266
MT0077,79467,80180,713,,3224
MT0078,80614,81660,1046,,3212
MT0079,81666,82655,989,,3194
MT0080,82738,83970,1232,,3164
MT0081,83986,85155,1169,,3122
MT0082,85562,85176,386,,3068
MT0083,86480,85629,851,,3050
MT0084,86518,87120,602,,3038
MT0085,87791,87201,590,,3032
MT0085.1,88000,87791,209,,3026
MT0086,88194,89012,818,,3005
MT0087,89057,89467,410,,2981
MT0088,89565,89906,341,,2975
MT0089,89914,90390,476,,2975
MT0090,90390,92309,1919,,2939
MT0091,92318,93265,947,,2936
MT0092,93279,93938,659,,2906
MT0093,93941,95404,1463,,2903
MT0095,95590,96879,1289,,2903
MT0096,96917,97588,671,,2900
MT0098,97748,98338,590,,2897
MT0099,98470,99237,767,,2891
MT0099.1,99259,99627,368,,2885
MT0100,99674,100438,764,,2873
MT0101,100573,102855,2282,,2861
MT0102,103653,102808,845,,2846
MT0103,104563,103703,860,,2840
MT0104,105091,104427,664,,2834
MT0105,105314,106702,1388,,2831
MT0106,106724,107590,866,,2828
MT0107,107590,108138,548,,2822
MT0108,108146,109765,1619,,2801
MT0109,109773,110006,233,,2800
MT0110,109967,117526,7559,,2759
MT0111,117704,119686,1982,,2740
MT0112,122163,119908,2255,,2717
MT0113,122307,123818,1511,,2714
MT0114,124254,123973,281,,2711
MT0115,124364,125557,1193,,2711
MT0116,130532,125658,4874,,2702
MT0116.1,130572,130694,122,,2702
MT0117,131092,130889,203,,2699
MT0118,131263,132861,1598,,2651
MT0119,132907,133758,851,,2645
MT0120,133942,135996,2054,,2645
MT0121,136281,137234,953,,2636
MT0122,137242,138501,1259,,2630
MT0123,138504,139661,1157,,2627
MT0124,139947,140132,185,,2627
MT0125,140890,140261,629,,2624
MT0125.1,141185,142132,947,,2621
MT0126,143867,142122,1745,,2612
MT0127,143989,145614,1625,,2603
MT0128,147762,145621,2141,,2588
MT0129,148333,147902,431,,2588
MT0130,148862,148446,416,,2582
MT0131,148847,149212,365,,2576
MT0132,149482,151164,1682,,2567
MT0133,151319,152383,1064,,2564
MT0134,152495,154297,1802,,2564
MT0135,154403,155767,1364,,2561
MT0136,155838,156614,776,,2558
MT0137,157789,156752,1037,,2543
MT0138,158018,158470,452,,2543
MT0139,159829,158489,1340,,2537
MT0140,160953,159874,1079,,2537
MT0141,161040,161642,602,,2516
MT0142,161942,162841,899,,2513
MT0143,163420,162818,602,,2495
MT0144,163537,164859,1322,,2492
MT0145,165431,164886,545,,2459
MT0146,165494,165994,500,,2453
MT0147,165998,167017,1019,,2450
MT0148,167081,167458,377,,2441
MT0149,167852,167445,407,,2429
MT0150,167882,168805,923,,2423
MT0151,170353,168878,1475,,2423
MT0152,170455,171294,839,,2411
MT0153,171386,172336,950,,2396
MT0154,172373,173311,938,,2390
MT0155,173454,174926,1472,,2378
MT0156,174983,175861,878,,2375
MT0157,175871,176836,965,,2372
MT0158,177123,176839,284,,2369
MT0159,177559,177681,122,,2366
MT0160,179480,177717,1763,,2363
MT0161,181091,179493,1598,,2360
MT0162,182156,181329,827,,2357
MT0163,183381,182161,1220,,2354
MT0164,183793,185220,1427,,2348
MT0165,185220,186644,1424,,2341
MT0167,186953,187594,641,,2336
MT0168,189007,187604,1403,,2327
MT0169,190607,189102,1505,,2324
MT0170,190775,192122,1347,,2312
MT0171,193304,192156,1148,,2312
MT0172,193286,193738,452,,2312
MT0173,193795,194277,482,,2312
MT0174,194984,194316,668,,2306
MT0175,195270,196823,1553,,2305
MT0176,197030,197824,794,,2297
MT0177,198455,197781,674,,2294
MT0178,198484,200064,1580,,2291
MT0179,200064,201101,1037,,2284
MT0180,201128,202645,1517,,2282
MT0181,202645,204234,1589,,2279
MT0182,204237,205403,1166,,2279
MT0183,205400,206944,1544,,2276
MT0184,206983,207564,581,,2276
MT0185,207570,208529,959,,2273
MT0186,208529,209080,551,,2270
MT0187,209050,209781,731,,2270
MT0188,210924,209818,1106,,2267
MT0189,212362,211007,1355,,2261
MT0190,213123,212392,731,,2255
MT0191,214252,213143,1109,,2255
MT0192,214068,215036,968,,2249
MT0193,215081,215827,746,,2246
MT0194,215827,216333,506,,2246
MT0195,216381,218453,2072,,2240
MT0196,218663,218505,158,,2234
MT0197,218823,219476,653,,2222
MT0198,219598,220026,428,,2222
MT0199,221835,220111,1724,,2219
MT0200,221983,222270,287,,2216
MT0201,222401,223639,1238,,2213
MT0202,223676,224773,1097,,2213
MT0203,226662,224839,1823,,2210
MT0204,226849,230571,3722,,2210
MT0204.1,230593,230739,146,,2204
MT0205,230876,231643,767,,2192
MT0206,231759,232340,581,,2192
MT0207,232340,234586,2246,,2189
MT0208,236621,234633,1988,,2186
MT0209,236775,237320,545,,2183
MT0210,237320,238006,686,,2174
MT0211,238503,238009,494,,2174
MT0212,241406,238509,2897,,2171
MT0213,241628,242035,407,,2168
MT0214,243328,242093,1235,,2162
MT0215,243498,244598,1100,,2162
MT0216,247432,244601,2831,,2159
MT0217,248232,247501,731,,2156
MT0218,249020,248232,788,,2153
MT0219,249152,250234,1082,,2153
MT0220,250267,251709,1442,,2141
MT0221,251896,253713,1817,,2135
MT0222,254754,253786,968,,2132
MT0223,256064,254754,1310,,2126
MT0224,256178,257788,1610,,2114
MT0225,259018,257900,1118,,2102
MT0226,259027,260037,1010,,2102
MT0227,260858,260040,818,,2099
MT0228,261038,262363,1325,,2096
MT0229,262368,262913,545,,2096
MT0230,262926,264134,1208,,2090
MT0231,264241,265587,1346,,2084
MT0232,265621,266406,785,,2081
MT0233,267878,266418,1460,,2081
MT0234,268741,267980,761,,2075
MT0235,268777,269928,1151,,2072
MT0236,271678,269951,1727,,2069
MT0237,272953,271691,1262,,2060
MT0238,273253,274389,1136,,2057
MT0239,275100,274423,677,,2057
MT0240,276134,275100,1034,,2054
MT0241,276172,277875,1703,,2051
MT0242,278013,278699,686,,2042
MT0244,278699,279640,941,,2042
MT0245,281122,279722,1400,,2036
MT0246,282728,281283,1445,,2036
MT0247,286965,282766,4199,,2030
MT0250,287560,287015,545,,2021
MT0251,287300,288463,1163,,2018
MT0252,288542,289153,611,,2018
MT0253,289218,289448,230,,2015
MT0254,289459,289893,434,,2015
MT0255,290768,289929,839,,2000
MT0256,292143,290782,1361,,2000
MT0257,292285,293604,1319,,2000
MT0258,295748,293916,1832,,1997
MT0259,296120,296605,485,,1997
MT0260,296885,298231,1346,,1991
MT0261,298977,298234,743,,1991
MT0262,300918,298981,1937,,1988
MT0263,301770,300952,818,,1988
MT0264,302083,301853,230,,1982
MT0265,302767,302291,476,,1979
MT0266,302981,305539,2558,,1979
MT0267,306464,305943,521,,1976
MT0268,307973,306492,1481,,1973
MT0269,309662,307995,1667,,1970
MT0270,309766,309662,104,,1970
MT0270.1,309814,310185,371,,1967
MT0270.2,310145,310390,245,,1964
MT0271,310864,310412,452,,1961
MT0272,311632,310892,740,,1961
MT0273,312774,311632,1142,,1958
MT0274,314283,312877,1406,,1955
MT0275,314969,314427,542,,1955
MT0276,315881,314982,899,,1952
MT0277,316572,315901,671,,1949
MT0278,317618,316629,989,,1949
MT0279,321268,317643,3625,,1949
MT0280,321445,322833,1388,,1940
MT0281,323387,322881,506,,1937
MT0282,324636,323455,1181,,1937
MT0283,324681,326360,1679,,1937
MT0284,328575,326383,2192,,1931
MT0285,329705,328692,1013,,1928
MT0286,330439,329822,617,,1928
MT0286.1,330494,331114,620,,1925
MT0287,331772,331050,722,,1925
MT0288,331862,332779,917,,1922
MT0289,333250,332825,425,,1919
MT0290,333531,333277,254,,1919
MT0291,336268,333554,2714,,1916
MT0291.1,336255,336407,152,,1916
MT0291.2,336525,336397,128,,1913
MT0291.3,336850,336659,191,,1911
MT0291.4,337082,338875,1793,,1910
MT0292,339309,341033,1724,,1910
MT0293,341060,341965,905,,1907
MT0294,342155,342051,104,,1904
MT0295,342246,344084,1838,,1904
MT0296,344084,345697,1613,,1901
MT0297,345697,349686,3989,,1898
MT0298,349686,349991,305,,1892
MT0299,349997,351535,1538,,1886
MT0300,351587,351877,290,,1884
MT0301,351910,352197,287,,1883
MT0302,352211,353095,884,,1883
MT0303,353145,354560,1415,,1877
MT0304,354701,355942,1241,,1877
MT0305,355942,356934,992,,1874
MT0306,358126,356927,1199,,1871
MT0307,358233,359015,782,,1871
MT0308,359810,359010,800,,1868
MT0310,361217,359823,1394,,1868
MT0311,361303,363168,1865,,1868
MT0312,363314,363538,224,,1865
MT0313,363691,363837,146,,1865
MT0314,364106,364528,422,,1862
MT0315,364667,365296,629,,1862
MT0316,365296,366201,905,,1859
MT0318,375772,366215,9557,,1859
MT0319,375975,376643,668,,1853
MT0320,377116,376637,479,,1853
MT0321,377174,377887,713,,1851
MT0322,377992,378645,653,,1844
MT0323,379209,378721,488,,1844
MT0324,379233,380459,1226,,1841
MT0325,380503,380598,95,,1838
MT0326,380617,382476,1859,,1835
MT0327,382551,382934,383,,1833
MT0328,383125,382943,182,,1832
MT0328.1,383070,383312,242,,1832
MT0328.2,383601,383194,407,,1829
MT0329,383662,384543,881,,1829
MT0330,384595,385206,611,,1829
MT0332,385970,385236,734,,1826
MT0333,387141,386368,773,,1826
MT0334,387208,387873,665,,1826
MT0335,387948,388607,659,,1826
MT0336,388642,389211,569,,1823
MT0337,389320,390648,1328,,1817
MT0338,391311,390643,668,,1814
MT0339,391412,392089,677,,1808
MT0340,392099,392320,221,,1808
MT0341,392333,392785,452,,1808
MT0342,394105,392759,1346,,1808
MT0343,394171,394770,599,,1808
MT0344,395380,394757,623,,1805
MT0345,396147,395410,737,,1805
MT0346,396261,397424,1163,,1805
MT0347,398628,397642,986,,1802
MT0348,398718,399581,863,,1799
MT0349,400110,399598,512,,1796
MT0350,400252,401760,1508,,1793
MT0351,403222,401936,1286,,1790
MT0352,405901,403256,2645,,1790
MT0353,408508,406013,2495,,1790
MT0355,408694,409230,536,,1787
MT0356,409416,410858,1442,,1781
MT0357,410898,412817,1919,,1778
MT0357.1,412817,414295,1478,,1778
MT0359,415001,414444,557,,1778
MT0360,415104,415517,413,,1775
MT0361,417025,415565,1460,,1775
MT0362,417364,418347,983,,1772
MT0363,418353,419003,650,,1772
MT0364,419126,419665,539,,1772
MT0365,419895,421769,1874,,1772
MT0366,421859,422473,614,,1772
MT0367,422512,423696,1184,,1769
MT0368,423699,424076,377,,1769
MT0369,424863,424309,554,,1766
MT0370,434767,424943,9824,,1766
MT0372,435547,434921,626,,1763
MT0373,436857,435562,1295,,1760
MT0374,436948,437592,644,,1760
MT0375,437747,438382,635,,1757
MT0376,438803,438393,410,,1757
MT0377,438910,439734,824,,1754
MT0378,439959,441338,1379,,1754
MT0379,442387,441356,1031,,1754
MT0380,442483,443163,680,,1751
MT0381,444285,443158,1127,,1751
MT0382,444903,444313,590,,1751
MT0383,444914,445339,425,,1751
MT0384,446613,445405,1208,,1748
MT0384.1,447221,446622,599,,1748
MT0385,448131,447238,893,,1748
MT0386,448721,448131,590,,1748
MT0387,449473,448721,752,,1745
MT0388,451891,449495,2396,,1745
MT0389,452367,451891,476,,1745
MT0390,453284,452385,899,,1745
MT0391,454510,455472,962,,1742
MT0392,456226,455651,575,,1739
MT0393,456908,456360,548,,1739
MT0394,457768,457007,761,,1739
MT0395,458469,457933,536,,1736
MT0396,459404,458553,851,,1736
MT0397,462091,459548,2543,,1733
MT0398,462119,463393,1274,,1733
MT0399,463479,466754,3275,,1733
MT0400,468092,466764,1328,,1733
MT0401,468426,469682,1256,,1733
MT0402,470101,471318,1217,,1730
MT0403,472730,471321,1409,,1727
MT0404,472872,474194,1322,,1727
MT0404.1,474932,474216,716,,1726
MT0405,475031,475432,401,,1724
MT0406,475417,475830,413,,1724
MT0407,476344,475877,467,,1724
MT0407.1,476485,476730,245,,1718
MT0408,477411,476773,638,,1718
MT0409,478647,477421,1226,,1718
MT0410,479847,478660,1187,,1715
MT0411,479880,480248,368,,1712
MT0412,483322,480449,2873,,1712
MT0413,484316,483435,881,,1712
MT0414,484693,484370,323,,1703
MT0415,485105,484653,452,,1703
MT0416,485426,485316,110,,1700
MT0417,485426,487180,1754,,1700
MT0418,487180,491385,4205,,1700
MT0419,492094,491339,755,,1697
MT0420,492232,493239,1007,,1697
MT0421,493235,495304,2069,,1697
MT0422,495300,496454,1154,,1694
MT0423,498820,496514,2306,,1694
MT0424,499749,498766,983,,1691
MT0425,501068,499752,1316,,1688
MT0426,501162,501812,650,,1688
MT0427,502467,501802,665,,1688
MT0428,502597,503616,1019,,1685
MT0429,503616,503819,203,,1685
MT0430,503815,504570,755,,1685
MT0431,504595,504744,149,,1685
MT0432,504966,506444,1478,,1685
MT0433,506535,508028,1493,,1682
MT0434,508420,508013,407,,1682
MT0435,509210,508584,626,,1682
MT0436,510004,509210,794,,1679
MT0437,511680,510034,1646,,1679
MT0438,512104,511829,275,,1679
MT0440,516770,512154,4616,,1679
MT0441,517397,516825,572,,1679
MT0442,518341,517469,872,,1676
MT0443,519291,518347,944,,1673
MT0444,519845,519255,590,,1673
MT0445,519978,520487,509,,1673
MT0446,520522,521013,491,,1673
MT0447,521049,521768,719,,1673
MT0448,521752,522900,1148,,1670
MT0449,522960,523613,653,,1667
MT0450,523732,523625,107,,1667
MT0451,525982,523799,2183,,1667
MT0452,526845,525982,863,,1664
MT0453,527531,526839,692,,1661
MT0454,528809,527595,1214,,1661
MT0455,529844,528831,1013,,1661
MT0456,530057,531676,1619,,1658
MT0457,532173,531748,425,,1658
MT0458,533663,532203,1460,,1658
MT0459,533803,534357,554,,1655
MT0460,535238,534543,695,,1652
MT0461,535845,535285,560,,1652
MT0462,536703,535897,806,,1649
MT0463,538121,536676,1445,,1649
MT0464,538684,537956,728,,1646
MT0465,539997,538681,1316,,1646
MT0466,542940,540040,2900,,1646
MT0467,543359,542940,419,,1646
MT0468,543540,544298,758,,1646
MT0469,544623,546176,1553,,1643
MT0470,546739,546188,551,,1643
MT0471,547351,546827,524,,1643
MT0472,548252,547341,911,,1643
MT0472.1,548472,548939,467,,1643
MT0473,551056,549038,2018,,1643
MT0474,551124,552644,1520,,1640
MT0475,552647,553135,488,,1640
MT0476,553159,553434,275,,1640
MT0477,553397,553996,599,,1640
MT0478,554063,555454,1391,,1637
MT0479,555465,555755,290,,1634
MT0480,556334,555765,569,,1634
MT0481,557755,556334,1421,,1628
MT0482,557907,558698,791,,1628
MT0483,558976,560259,1283,,1628
MT0484,560344,561201,857,,1625
MT0485,561319,562193,874,,1625
MT0486,563159,562299,860,,1625
MT0487,563742,563305,437,,1625
MT0488,564161,563676,485,,1625
MT0489,564941,564174,767,,1625
MT0490,565156,566379,1223,,1625
MT0491,566469,566888,419,,1622
MT0492,567067,566933,134,,1622
MT0493,567230,567841,611,,1622
MT0494,568009,567860,149,,1619
MT0495,568125,568667,542,,1619
MT0496,568670,569341,671,,1619
MT0497,570415,569372,1043,,1616
MT0498,571434,570415,1019,,1616
MT0499,571960,571439,521,,1616
MT0500,571987,573093,1106,,1616
MT0501,573158,574510,1352,,1616
MT0502,575249,574497,752,,1616
MT0503,575432,576745,1313,,1613
MT0504,576796,578235,1439,,1613
MT0505,578235,578783,548,,1610
MT0506,578896,579000,104,,1610
MT0507,579054,579656,602,,1610
MT0508,579816,580562,746,,1607
MT0509,580739,581968,1229,,1604
MT0510,582167,582856,689,,1604
MT0511,584298,582859,1439,,1604
MT0512,584911,584237,674,,1601
MT0513,586058,585072,986,,1601
MT0514,586063,586788,725,,1601
MT0515,587682,586795,887,,1598
MT0516,587714,588745,1031,,1598
MT0517,588745,589674,929,,1598
MT0518,589693,590532,839,,1598
MT0519,590551,591423,872,,1598
MT0520,591451,592335,884,,1595
MT0521,592479,592712,233,,1595
MT0522,593022,594149,1127,,1595
MT0523,594159,595232,1073,,1595
MT0524,596207,595242,965,,1592
MT0525,596107,596700,593,,1592
MT0526,597757,596834,923,,1592
MT0527,598132,598566,434,,1589
MT0528,598566,601469,2903,,1589
MT0529,601465,601755,290,,1586
MT0530,601727,603211,1484,,1586
MT0531,603215,604150,935,,1586
MT0532,604177,605880,1703,,1586
MT0533,605969,606955,986,,1586
MT0534,606971,607516,545,,1586
MT0535,607516,607812,296,,1583
MT0536,607825,609426,1601,,1583
MT0537,609905,609429,476,,1583
MT0538,610191,611420,1229,,1583
MT0539,611555,612247,692,,1583
MT0540,612418,612305,113,,1580
MT0541,613441,612542,899,,1580
MT0542,613622,613969,347,,1580
MT0543,613965,614267,302,,1580
MT0544,614405,615706,1301,,1580
MT0545,616097,615696,401,,1580
MT0546,616202,617587,1385,,1577
MT0547,617590,618195,605,,1577
MT0548,618213,618860,647,,1574
MT0549,618860,619636,776,,1574
MT0550,619672,621258,1586,,1571
MT0551,621258,622229,971,,1571
MT0552,622274,623488,1214,,1568
MT0553,623649,623491,158,,1568
MT0554,623696,624010,314,,1568
MT0555,623985,624164,179,,1565
MT0556,624160,626025,1865,,1565
MT0557,626931,625927,1004,,1562
MT0558,627891,627016,875,,1559
MT0559,627926,628699,773,,1559
MT0560,628699,629736,1037,,1559
MT0562,631182,629752,1430,,1556
MT0563,631491,633134,1643,,1553
MT0564,633170,633823,653,,1553
MT0565,633850,634482,632,,1553
MT0566,635856,634378,1478,,1553
MT0567,636956,635871,1085,,1553
MT0568,636909,637433,524,,1550
MT0569,637665,637390,275,,1550
MT0570,638915,637665,1250,,1547
MT0571,639421,639038,383,,1547
MT0572,640368,639487,881,,1547
MT0573,641408,640467,941,,1545
MT0573.1,641558,641427,131,,1544
MT0574,642093,641683,410,,1544
MT0575,642356,642093,263,,1544
MT0576,642340,642492,152,,1544
MT0577,644263,642551,1712,,1541
MT0578,644227,645942,1715,,1541
MT0579,645942,646919,977,,1541
MT0580,646919,647704,785,,1538
MT0581,647750,649411,1661,,1538
MT0582,649411,649923,512,,1538
MT0583,649898,651121,1223,,1538
MT0584,651186,651842,656,,1535
MT0585,652197,651862,335,,1535
MT0586,652956,652234,722,,1535
MT0587,654207,652984,1223,,1535
MT0588,654223,655227,1004,,1532
MT0589,655331,656188,857,,1532
MT0590,657401,656379,1022,,1532
MT0591,658922,657465,1457,,1529
MT0592,659491,659003,488,,1529
MT0593,659770,660789,1019,,1529
MT0594,660902,662317,1415,,1526
MT0595,662317,662718,401,,1526
MT0596,662618,664822,2204,,1526
MT0597,666293,664941,1352,,1523
MT0598,666496,666377,119,,1523
MT0599,666834,666496,338,,1523
MT0600,667052,666888,164,,1522
MT0601,668693,667305,1388,,1522
MT0602,669845,668706,1139,,1520
MT0603,669938,670039,101,,1520
MT0604,671196,670033,1163,,1520
MT0605,671290,672600,1310,,1520
MT0606,672611,673399,788,,1520
MT0607,677367,673450,3917,,1520
MT0608,677282,677758,476,,1517
MT0608.1,677737,678444,707,,1517
MT0609,679154,678579,575,,1517
MT0610,679804,679181,623,,1514
MT0611,680526,679843,683,,1514
MT0612,680680,683310,2630,,1514
MT0613,684904,683339,1565,,1514
MT0614,685182,685787,605,,1514
MT0615,685859,686578,719,,1511
MT0616,686578,687372,794,,1511
MT0617,687377,688261,884,,1511
MT0618,688270,689481,1211,,1511
MT0619,689445,690305,860,,1508
MT0620,690257,690508,251,,1508
MT0621,690496,691815,1319,,1508
MT0622,691949,693472,1523,,1508
MT0623,693472,694677,1205,,1508
MT0624,694616,696232,1616,,1505
MT0625,696682,696290,392,,1505
MT0626,696933,696679,254,,1505
MT0627,698351,697119,1232,,1505
MT0628,699015,698605,410,,1505
MT0629,699275,699015,260,,1505
MT0630,700485,699355,1130,,1502
MT0631,701229,700489,740,,1502
MT0632,701687,702634,947,,1502
MT0633,702854,703459,605,,1502
MT0635,703386,704204,818,,1502
MT0636,704245,704685,440,,1499
MT0637,704690,704932,242,,1499
MT0638,704932,705330,398,,1496
MT0638.1,705330,705500,170,,1493
MT0639,705870,706202,332,,1493
MT0640,707355,706201,1154,,1490
MT0641,707790,707410,380,,1490
MT0642,707770,708372,602,,1487
MT0643,710961,708397,2564,,1487
MT0644,710901,711791,890,,1487
MT0645,711773,712030,257,,1484
MT0645.1,712263,712033,230,,1484
MT0645.2,712228,712452,224,,1484
MT0646,712452,712850,398,,1484
MT0647,712982,714162,1180,,1484
MT0648,714162,715250,1088,,1484
MT0649,715648,716709,1061,,1484
MT0650,716672,717760,1088,,1481
MT0651,717856,718107,251,,1481
MT0652,718110,718502,392,,1481
MT0653,719435,718602,833,,1481
MT0654,719471,719728,257,,1481
MT0655,720147,719656,491,,1478
MT0656,721358,720210,1148,,1478
MT0657,723136,721454,1682,,1478
MT0658,726459,723178,3281,,1478
MT0659,729752,726462,3290,,1478
MT0660,730723,730031,692,,1475
MT0661,731632,730775,857,,1475
MT0662,732478,731768,710,,1475
MT0662.1,732558,732806,248,,1475
MT0663,733157,733321,164,,1472
MT0664,733375,733848,473,,1472
MT0665,733838,734263,425,,1472
MT0666,734270,734767,497,,1472
MT0667,735425,735664,239,,1472
MT0668,735699,736412,713,,1472
MT0669,736467,736892,425,,1471
MT0669.1,736962,737666,704,,1469
MT0670,738685,737741,944,,1469
MT0671,739613,738711,902,,1466
MT0672,740690,739740,950,,1466
MT0673,741657,740770,887,,1466
MT0674,742684,741677,1007,,1466
MT0675,744057,742594,1463,,1463
MT0676,744143,748336,4193,,1463
MT0677,748264,749007,743,,1463
MT0679,749010,749915,905,,1460
MT0680,750249,750782,533,,1460
MT0681,750822,751211,389,,1460
MT0682,751980,751210,770,,1460
MT0683,751973,753475,1502,,1460
MT0684,753559,754566,1007,,1460
MT0685,755340,754960,380,,1457
MT0686,755590,755438,152,,1457
MT0687,756382,755669,713,,1457
MT0688,756966,756661,305,,1457
MT0689,757204,756956,248,,1454
MT0690,757745,757311,434,,1454
MT0691,758122,757745,377,,1454
MT0692,758110,760470,2360,,1451
MT0692.1,760536,760859,323,,1451
MT0693,760774,761109,335,,1451
MT0694,761267,761494,227,,1448
MT0695,761762,765295,3533,,1445
MT0696,765343,769290,3947,,1445
MT0697,769664,769293,371,,1445
MT0698,771571,769660,1911,,1445
MT0699,771766,772521,755,,1444
MT0700,772556,773395,839,,1442
MT0701,773458,775083,1625,,1442
MT0702,775097,776032,935,,1442
MT0703,776038,776757,719,,1442
MT0704,776757,777545,788,,1442
MT0705,780454,777563,2891,,1439
MT0706,780879,780454,425,,1439
MT0706.1,780964,781458,494,,1439
MT0707,782014,781520,494,,1439
MT0708,782390,782019,371,,1439
MT0709,782629,783282,653,,1439
MT0710,783534,783905,371,,1439
MT0711,783908,784375,467,,1436
MT0712,784459,786561,2102,,1436
MT0713,786795,787982,1187,,1436
MT0714,788123,788917,794,,1436
MT0715,789073,789897,824,,1436
MT0716,789914,791131,1217,,1436
MT0717,791385,791134,251,,1433
MT0717.1,791773,791501,272,,1433
MT0718,793047,792001,1046,,1430
MT0719,793640,793047,593,,1430
MT0719.1,793632,793817,185,,1427
MT0719.2,793823,794131,308,,1427
MT0720,794131,795303,1172,,1427
MT0721,795309,796565,1256,,1427
MT0722,796688,797440,752,,1427
MT0723,797492,798901,1409,,1424
MT0724,798906,800342,1436,,1424
MT0724.1,800335,800535,200,,1424
MT0725,800672,800767,95,,1424
MT0726,801780,801136,644,,1424
MT0726.1,802367,802080,287,,1421
MT0727,802460,802762,302,,1421
MT0728,802782,803432,650,,1421
MT0729,803435,804103,668,,1421
MT0730,804106,804405,299,,1421
MT0731,804717,805556,839,,1418
MT0732,805600,805878,278,,1418
MT0733,805878,806468,590,,1418
MT0734,806471,807292,821,,1418
MT0735,807299,807712,413,,1418
MT0736,807715,807945,230,,1418
MT0737,807948,808352,404,,1418
MT0738,808614,810884,2270,,1415
MT0739,810935,811831,896,,1415
MT0740,812135,813073,938,,1415
MT0740.1,813244,813372,128,,1415
MT0741,813562,813927,365,,1415
MT0741.1,813931,814245,314,,1415
MT0742,814248,814808,560,,1415
MT0742.1,814816,814998,182,,1412
MT0743,815166,815561,395,,1412
MT0744,815588,816124,536,,1412
MT0745,816130,816495,365,,1412
MT0746,816518,817177,659,,1409
MT0747,817183,817377,194,,1409
MT0748,817380,817817,437,,1409
MT0749,818105,819721,1616,,1409
MT0750,820634,819732,902,,1409
MT0751,821830,820730,1100,,1406
MT0752,822689,822036,653,,1406
MT0753,823666,822689,977,,1406
MT0754,823697,825040,1343,,1406
MT0755,825056,825781,725,,1406
MT0756,826829,825876,953,,1406
MT0756.1,826990,828312,1322,,1403
MT0757,828312,828854,542,,1403
MT0758,828860,829657,797,,1403
MT0759,829733,830263,530,,1403
MT0760,830330,831079,749,,1403
MT0761,831137,831346,209,,1403
MT0762,831397,831891,494,,1400
MT0762.1,831891,832100,209,,1400
MT0763,832252,832797,545,,1400
MT0764,833045,833848,803,,1397
MT0765,833885,834130,245,,1397
MT0766,834130,834489,359,,1397
MT0767,834723,835034,311,,1397
MT0768,835179,835694,515,,1397
MT0768.1,836006,835869,137,,1394
MT0769,836632,836078,554,,1394
MT0770,837168,836632,536,,1394
MT0771,837394,837251,143,,1391
MT0772,837343,837867,524,,1391
MT0772.1,837890,840238,2348,,1388
MT0772.2,840318,840557,239,,1388
MT0772.5,840640,842994,2354,,1388
MT0772.6,843079,843342,263,,1388
MT0773,843369,843794,425,,1388
MT0773.1,844015,843881,134,,1388
MT0774,844150,844416,266,,1388
MT0775,845372,844491,881,,1388
MT0776,846555,845386,1169,,1388
MT0777,848094,846565,1529,,1388
MT0778,848300,850051,1751,,1388
MT0779,852184,850247,1937,,1385
MT0780,852698,852486,212,,1385
MT0781,852868,853638,770,,1385
MT0782,853770,854489,719,,1385
MT0783,854537,855991,1454,,1385
MT0784,856367,855969,398,,1385
MT0785,856826,856410,416,,1385
MT0786,857867,856842,1025,,1382
MT0787,858610,858068,542,,1382
MT0787.1,858855,858616,239,,1382
MT0788,860177,858825,1352,,1382
MT0789,861004,860180,824,,1379
MT0790,862212,861007,1205,,1379
MT0791,862850,862212,638,,1379
MT0792,863052,864518,1466,,1379
MT0793,864552,865295,743,,1379
MT0794,865396,866280,884,,1376
MT0795,866280,866711,431,,1376
MT0796,866726,867991,1265,,1376
MT0797,869529,867994,1535,,1376
MT0798,870491,869583,908,,1376
MT0799,870547,871167,620,,1370
MT0800,871903,871127,776,,1370
MT0801,872148,873563,1415,,1370
MT0802,873571,874812,1241,,1370
MT0803,875495,874815,680,,1367
MT0804,875483,876373,890,,1367
MT0805,876376,878529,2153,,1364
MT0806,878940,878464,476,,1364
MT0807,880597,878963,1634,,1364
MT0808,880627,881463,836,,1364
MT0809,881482,883179,1697,,1364
MT0810,883855,883220,635,,1364
MT0811,883832,884557,725,,1364
MT0812,884666,884902,236,,1361
MT0813,884902,885573,671,,1361
MT0814,886192,885596,596,,1361
MT0815,886942,886217,725,,1361
MT0816,887982,886942,1040,,1361
MT0817,889910,887982,1928,,1361
MT0818,890240,891388,1148,,1355
MT0819,892178,891384,794,,1355
MT0820,893182,892178,1004,,1355
MT0821,893227,894525,1298,,1355
MT0822,895537,894884,653,,1355
MT0823,895729,897990,2261,,1352
MT0824,897990,898616,626,,1352
MT0825,898740,899693,953,,1352
MT0826,901239,899644,1595,,1352
MT0827,901381,901277,104,,1349
MT0828,901544,901930,386,,1349
MT0829,902020,903600,1580,,1349
MT0830,903634,904725,1091,,1349
MT0831,904996,904817,179,,1349
MT0832,906249,905146,1103,,1347
MT0833,906314,907198,884,,1346
MT0834,907927,907250,677,,1346
MT0835,908022,907927,95,,1346
MT0836,908392,908093,299,,1346
MT0837,909227,908397,830,,1346
MT0838,909942,909523,419,,1346
MT0839,910751,909942,809,,1346
MT0840,910842,911645,803,,1346
MT0841,911645,912589,944,,1346
MT0842,912635,913408,773,,1343
MT0843,914108,913470,638,,1343
MT0844,916220,914169,2051,,1343
MT0845,917555,916389,1166,,1343
MT0846,918659,917646,1013,,1343
MT0847,919540,918824,716,,1343
MT0848,919507,920595,1088,,1343
MT0849,921048,920653,395,,1343
MT0850,921379,921771,392,,1340
MT0851,921879,922781,902,,1340
MT0852,923720,922806,914,,1340
MT0853,924472,924305,167,,1340
MT0854,924821,925270,449,,1337
MT0854.1,925270,927516,2246,,1337
MT0855,930385,927749,2636,,1337
MT0856,930646,931494,848,,1337
MT0856.1,932029,931481,548,,1337
MT0857,932925,932182,743,,1337
MT0858,933931,932906,1025,,1334
MT0859,934381,934196,185,,1334
MT0860,934695,935387,692,,1334
MT0861,935477,936286,809,,1331
MT0862,937217,936360,857,,1331
MT0863,937493,937732,239,,1331
MT0864,937976,939301,1325,,1328
MT0865,939288,940289,1001,,1328
MT0866,941006,940359,647,,1328
MT0867,941078,942364,1286,,1328
MT0868,942469,942353,116,,1325
MT0869,944094,942583,1511,,1325
MT0870,944219,944632,413,,1325
MT0871,944742,945952,1210,,1322
MT0872,945955,947210,1255,,1322
MT0873,947210,947539,329,,1322
MT0874,948375,947542,833,,1322
MT0875,948457,949290,833,,1319
MT0876,951016,949337,1679,,1319
MT0877,951081,951521,440,,1319
MT0878,951530,952606,1076,,1319
MT0879,952693,953124,431,,1316
MT0880,953155,953625,470,,1316
MT0881,954818,953628,1190,,1316
MT0882,954975,956183,1208,,1316
MT0883,956191,958350,2159,,1316
MT0884,960049,958424,1625,,1313
MT0885,962616,960349,2267,,1313
MT0886,962603,962881,278,,1313
MT0887,962894,963394,500,,1313
MT0888,963394,963873,479,,1310
MT0889,963873,964295,422,,1310
MT0890,965539,964319,1220,,1310
MT0891,966265,965990,275,,1310
MT0892,967351,966272,1079,,1310
MT0892.1,967737,967351,386,,1310
MT0893,967902,968306,404,,1310
MT0894,970257,968431,1826,,1307
MT0895,970529,970341,188,,1307
MT0896,970518,972467,1949,,1307
MT0897,973842,972562,1280,,1307
MT0898,974306,973821,485,,1307
MT0899,975982,974306,1676,,1307
MT0900,976087,976872,785,,1307
MT0901,978218,976887,1331,,1307
MT0902,978768,978496,272,,1304
MT0903,979400,978768,632,,1304
MT0904,979512,980237,725,,1304
MT0905,980237,980518,281,,1304
MT0906,981279,980521,758,,1304
MT0907,982566,981439,1127,,1301
MT0908,982774,983793,1019,,1301
MT0909,983815,985539,1724,,1301
MT0910,986037,985528,509,,1301
MT0910.1,986004,986156,152,,1298
MT0910.2,986281,986544,263,,1298
MT0910.3,986686,986832,146,,1298
MT0910.4,986892,986749,143,,1298
MT0911,987194,988714,1520,,1298
MT0912,989873,988755,1118,,1295
MT0914,992608,989963,2645,,1295
MT0915,993467,992613,854,,1295
MT0915.1,993473,993865,392,,1295
MT0916,993865,995349,1484,,1295
MT0917,996307,995333,974,,1292
MT0918,996536,997714,1178,,1292
MT0919,997749,999308,1559,,1292
MT0920,999484,1000776,1292,,1292
MT0921,1002427,1000823,1604,,1292
MT0921.1,1002716,1002456,260,,1292
MT0922,1002824,1003801,977,,1292
MT0923,1003817,1003966,149,,1292
MT0924,1003966,1004493,527,,1289
MT0925,1005922,1004516,1406,,1289
MT0926,1006574,1005867,707,,1289
MT0927,1008192,1006708,1484,,1289
MT0928,1008219,1008947,728,,1286
MT0929,1008956,1010071,1115,,1286
MT0930,1010059,1011744,1685,,1286
MT0931,1011744,1014134,2390,,1286
MT0932,1014407,1014565,158,,1286
MT0933,1014694,1014870,176,,1286
MT0934,1014879,1015310,431,,1286
MT0934.1,1015411,1016181,770,,1286
MT0936,1016429,1016695,266,,1286
MT0937,1017240,1016836,404,,1286
MT0938,1018738,1017233,1505,,1283
MT0939,1019978,1018743,1235,,1283
MT0940,1021351,1020074,1277,,1283
MT0941,1021656,1021360,296,,1283
MT0942,1022100,1023878,1778,,1283
MT0943,1023878,1024132,254,,1283
MT0944,1024164,1024697,533,,1283
MT0945,1024697,1025194,497,,1280
MT0946,1025329,1025186,143,,1280
MT0947,1026829,1025513,1316,,1280
MT0948,1027117,1027695,578,,1280
MT0949,1027698,1029347,1649,,1280
MT0950,1030590,1029529,1061,,1277
MT0951,1031880,1030594,1286,,1277
MT0952,1032646,1031912,734,,1277
MT0953,1033799,1032726,1073,,1277
MT0954,1034644,1033856,788,,1277
MT0955,1034859,1036025,1166,,1277
MT0956,1036041,1037012,971,,1277
MT0957,1037012,1037923,911,,1277
MT0958,1039927,1037936,1991,,1274
MT0959,1041061,1039952,1109,,1274
MT0960,1041277,1042104,827,,1274
MT0961,1042128,1043249,1121,,1274
MT0962,1043312,1044325,1013,,1274
MT0963,1044330,1045232,902,,1274
MT0964,1046033,1045215,818,,1271
MT0965,1046149,1048425,2276,,1271
MT0966,1048425,1050356,1931,,1271
MT0967,1051472,1050609,863,,1268
MT0968,1052330,1051560,770,,1268
MT0968.1,1052563,1052321,242,,1268
MT0969,1053704,1052712,992,,1268
MT0970,1053754,1054251,497,,1268
MT0971,1054260,1055018,758,,1265
MT0972,1056698,1055040,1658,,1265
MT0973,1057083,1056802,281,,1265
MT0974,1057543,1057316,227,,1265
MT0975,1058312,1057662,650,,1265
MT0976,1058273,1060585,2312,,1265
MT0977,1061667,1060672,995,,1262
MT0978,1061977,1063137,1160,,1262
MT0979,1063153,1064061,908,,1262
MT0980,1064975,1064064,911,,1262
MT0981,1065140,1066048,908,,1262
MT0982,1066091,1067455,1364,,1259
MT0983,1067574,1068218,644,,1259
MT0984,1068218,1069786,1568,,1259
MT0985,1069896,1071272,1376,,1256
MT0986,1071268,1073283,2015,,1256
MT0987,1073340,1073558,218,,1256
MT0988,1073558,1073938,380,,1256
MT0989,1074087,1074431,344,,1255
MT0990,1075127,1074456,671,,1253
MT0991,1075264,1075127,137,,1253
MT0992,1076110,1075313,797,,1253
MT0992.1,1076625,1076212,413,,1253
MT0993,1077231,1076794,437,,1253
MT0994,1077938,1077249,689,,1250
MT0995,1077988,1078344,356,,1250
MT0996,1078344,1078697,353,,1250
MT0997,1078690,1081065,2375,,1250
MT0998,1081065,1081694,629,,1250
MT0999.1,1082597,1081791,806,,1250
MT1000,1083763,1082600,1163,,1250
MT1001,1085763,1083763,2000,,1247
MT1002,1087364,1085772,1592,,1247
MT1003,1088509,1087364,1145,,1244
MT1003.1,1090188,1088509,1679,,1244
MT1004,1090356,1093156,2800,,1244
MT1006.1,1094383,1093379,1004,,1244
MT1007,1094562,1095083,521,,1244
MT1008,1096535,1095108,1427,,1244
MT1009,1096855,1097544,689,,1244
MT1010,1097547,1099058,1511,,1244
MT1011,1099159,1100496,1337,,1241
MT1012,1100496,1101041,545,,1241
MT1013,1101519,1101067,452,,1241
MT1014,1101842,1102585,743,,1241
MT1015,1102581,1105145,2564,,1241
MT1017,1105155,1106312,1157,,1241
MT1018,1107445,1106447,998,,1238
MT1019,1108138,1107485,653,,1238
MT1020,1108564,1108214,350,,1238
MT1021,1109204,1108620,584,,1238
MT1022,1109311,1110228,917,,1238
MT1023,1110308,1111585,1277,,1238
MT1024,1111651,1112259,608,,1238
MT1025,1112324,1113496,1172,,1235
MT1025.1,1113673,1113810,137,,1235
MT1025.2,1113899,1114147,248,,1235
MT1025.3,1114420,1114214,206,,1235
MT1026,1114499,1114759,260,,1235
MT1027,1114837,1115784,947,,1232
MT1028,1115805,1116560,755,,1232
MT1029,1117186,1116572,614,,1232
MT1030,1117223,1118428,1205,,1232
MT1031,1119977,1118469,1508,,1232
MT1032,1120060,1120914,854,,1232
MT1033,1122240,1120930,1310,,1229
MT1034,1123918,1122278,1640,,1229
MT1035,1123758,1125458,1700,,1229
MT1036,1127047,1125491,1556,,1229
MT1037,1127424,1127924,500,,1229
MT1038,1128135,1129220,1085,,1229
MT1039,1129196,1130146,950,,1229
MT1040,1130235,1131152,917,,1229
MT1040.1,1131724,1131428,296,,1226
MT1041,1131690,1133300,1610,,1226
MT1042,1133952,1133380,572,,1226
MT1043,1134612,1133968,644,,1226
MT1044,1135509,1134832,677,,1226
MT1045,1136525,1135548,977,,1226
MT1046,1138158,1136620,1538,,1226
MT1047,1138344,1138949,605,,1226
MT1048,1139011,1142712,3701,,1223
MT1049,1142808,1143689,881,,1223
MT1050,1143702,1144508,806,,1223
MT1051,1144608,1145894,1286,,1223
MT1052,1145902,1146585,683,,1223
MT1053,1146581,1147069,488,,1223
MT1054,1147063,1148019,956,,1223
MT1054.1,1148200,1148027,173,,1223
MT1055,1148262,1148471,209,,1223
MT1056,1149151,1148474,677,,1220
MT1057,1151763,1149151,2612,,1220
MT1058,1152056,1153768,1712,,1220
MT1059,1153768,1155894,2126,,1220
MT1060,1155897,1156463,566,,1220
MT1061,1157999,1156473,1526,,1220
MT1062,1158837,1158010,827,,1217
MT1063,1159351,1158965,386,,1217
MT1065,1160105,1159422,683,,1217
MT1066,1160872,1160591,281,,1217
MT1067,1161225,1160902,323,,1217
MT1068,1162516,1161344,1172,,1217
MT1069,1163420,1162596,824,,1217
MT1070,1163734,1163868,134,,1217
MT1070.1,1163981,1164226,245,,1217
MT1071,1164516,1164211,305,,1214
MT1072,1165543,1164619,924,,1214
MT1073,1166851,1165829,1022,,1214
MT1074,1167098,1167718,620,,1214
MT1075,1167718,1168596,878,,1214
MT1075.1,1169469,1168684,785,,1214
MT1076,1169406,1170713,1307,,1214
MT1077,1170801,1170950,149,,1214
MT1078,1172199,1171087,1112,,1211
MT1079,1172432,1172875,443,,1211
MT1080,1172924,1173829,905,,1211
MT1081,1174746,1173994,752,,1211
MT1082,1175667,1175044,623,,1211
MT1083,1175769,1176155,386,,1211
MT1083.1,1176145,1176528,383,,1211
MT1083.2,1176612,1176947,335,,1211
MT1084,1176932,1177285,353,,1211
MT1085,1177674,1178435,761,,1210
MT1086,1178862,1178653,209,,1208
MT1087,1179241,1180620,1379,,1208
MT1088,1180730,1182358,1628,,1208
MT1089,1182395,1183498,1103,,1208
MT1090,1183554,1184024,470,,1207
MT1091,1184061,1184921,860,,1205
MT1092,1184902,1185783,881,,1205
MT1093,1186869,1185790,1079,,1205
MT1094,1187369,1186953,416,,1205
MT1095,1187481,1188044,563,,1205
MT1096,1188044,1188436,392,,1205
MT1096.1,1190470,1188470,2000,,1205
MT1096.2,1190575,1190694,119,,1202
MT1097,1192404,1190806,1598,,1202
MT1098,1192473,1192610,137,,1202
MT1099,1194508,1192700,1808,,1202
MT1100,1195278,1194508,770,,1199
MT1101,1196327,1195293,1034,,1199
MT1102,1196514,1197347,833,,1199
MT1103,1197457,1198314,857,,1199
MT1104,1199608,1198394,1214,,1199
MT1105,1200617,1199664,953,,1199
MT1106,1200819,1201892,1073,,1199
MT1107,1201969,1201862,107,,1196
MT1108,1201952,1203343,1391,,1196
MT1109,1203548,1204267,719,,1196
MT1110,1204302,1205465,1163,,1196
MT1111,1206033,1205542,491,,1193
MT1112,1206680,1206222,458,,1193
MT1113,1206755,1207618,863,,1193
MT1114,1207618,1207881,263,,1193
MT1115,1207871,1209889,2018,,1190
MT1116,1209902,1210018,116,,1190
MT1117,1210719,1209994,725,,1190
MT1118,1210830,1211615,785,,1190
MT1118.1,1211756,1214061,2305,,1190
MT1118.2,1214241,1214558,317,,1190
MT1119,1214696,1215145,449,,1190
MT1120,1215165,1215329,164,,1190
MT1121,1215426,1215605,179,,1190
MT1122,1215800,1216252,452,,1190
MT1122.1,1216650,1216504,146,,1187
MT1123,1216670,1218574,1904,,1187
MT1124,1219733,1218798,935,,1187
MT1125,1220121,1221398,1277,,1187
MT1126,1221506,1222330,824,,1187
MT1127,1222544,1223842,1298,,1184
MT1128,1223932,1224804,872,,1184
MT1129,1225691,1224813,878,,1184
MT1130,1227112,1225691,1421,,1184
MT1131,1228129,1227146,983,,1184
MT1132,1228380,1228928,548,,1184
MT1133,1230095,1228941,1154,,1184
MT1134,1230518,1230210,308,,1184
MT1135,1230754,1230521,233,,1181
MT1136,1230849,1232371,1522,,1181
MT1137,1233504,1232395,1109,,1181
MT1138,1233786,1233517,269,,1181
MT1139,1235008,1233764,1244,,1181
MT1140,1235643,1235008,635,,1181
MT1141,1235751,1236737,986,,1181
MT1142,1237740,1236760,980,,1181
MT1143,1237803,1238873,1070,,1181
MT1143.1,1238964,1239158,194,,1180
MT1144,1239158,1239529,371,,1178
MT1145,1239735,1240430,695,,1178
MT1147,1240503,1240733,230,,1178
MT1148,1240938,1240666,272,,1178
MT1149,1241181,1241501,320,,1178
MT1150,1242379,1241522,857,,1178
MT1151,1242612,1242415,197,,1178
MT1152,1243052,1242561,491,,1178
MT1153,1243255,1244652,1397,,1178
MT1154,1244677,1245696,1019,,1178
MT1155,1246627,1245695,932,,1175
MT1156,1246675,1247622,947,,1175
MT1157,1247630,1248208,578,,1175
MT1157.1,1248274,1248870,596,,1172
MT1158,1249482,1248880,602,,1172
MT1159,1250951,1249482,1469,,1172
MT1160,1252519,1251260,1259,,1172
MT1161,1254081,1252624,1457,,1172
MT1162,1254102,1255679,1577,,1172
MT1163,1255679,1256857,1178,,1172
MT1164,1256821,1258599,1778,,1172
MT1165,1260893,1258617,2276,,1169
MT1166,1261388,1261272,116,,1169
MT1167,1261469,1261702,233,,1169
MT1168,1263729,1261822,1907,,1169
MT1169,1263861,1264100,239,,1169
MT1169.1,1264153,1264491,338,,1169
MT1170,1264581,1264982,401,,1166
MT1171,1266035,1265022,1013,,1166
MT1172,1266406,1266035,371,,1166
MT1172.1,1266907,1266692,215,,1166
MT1173,1266836,1267681,845,,1166
MT1174,1268498,1267695,803,,1166
MT1175,1269447,1268644,803,,1166
MT1176,1269446,1270630,1184,,1166
MT1177,1270645,1271394,749,,1163
MT1178,1271680,1271528,152,,1163
MT1179.1,1271912,1274253,2341,,1163
MT1180,1274389,1275036,647,,1163
MT1181,1275131,1275460,329,,1163
MT1182,1275819,1275520,299,,1163
MT1183,1277288,1275792,1496,,1163
MT1184,1277383,1278307,924,,1163
MT1185,1279107,1278397,710,,1163
MT1186,1279145,1279507,362,,1162
MT1187,1280336,1279491,845,,1160
MT1188,1280920,1280336,584,,1160
MT1189,1280979,1281359,380,,1160
MT1190,1281520,1281705,185,,1160
MT1191,1281796,1282380,584,,1160
MT1192,1282380,1282523,143,,1160
MT1193,1283661,1282549,1112,,1160
MT1194,1284350,1283661,689,,1157
MT1195,1284477,1285772,1295,,1157
MT1196,1286077,1285775,302,,1157
MT1197,1286083,1286505,422,,1157
MT1198,1286816,1290511,3695,,1157
MT1199,1290553,1292226,1673,,1157
MT1200,1292271,1292888,617,,1157
MT1201,1292909,1293631,722,,1157
MT1202,1293656,1295539,1883,,1157
MT1203,1295640,1297544,1904,,1157
MT1204,1298180,1297578,602,,1157
MT1205,1299292,1298255,1037,,1157
MT1206,1299630,1299313,317,,1154
MT1207,1299792,1300700,908,,1154
MT1208,1300768,1301232,464,,1154
MT1209,1302169,1301246,923,,1154
MT1210,1302419,1304986,2567,,1154
MT1211,1305489,1305160,329,,1154
MT1212,1307714,1305693,2021,,1154
MT1213,1308454,1307714,740,,1154
MT1214,1308493,1308816,323,,1154
MT1215,1308852,1309937,1085,,1151
MT1216,1310738,1309971,767,,1151
MT1217,1312786,1310684,2102,,1151
MT1218,1313164,1319466,6302,,1151
MT1219,1319522,1320937,1415,,1151
MT1220,1321007,1324012,3005,,1151
MT1221,1325134,1324022,1112,,1148
MT1222,1326999,1325266,1733,,1148
MT1223,1328792,1327179,1613,,1148
MT1224,1328877,1330505,1628,,1148
MT1225,1330508,1331494,986,,1148
MT1226,1331579,1332448,869,,1148
MT1227,1332467,1333342,875,,1145
MT1228,1333376,1334329,953,,1145
MT1229,1334414,1335238,824,,1145
MT1230,1335281,1336699,1418,,1145
MT1231,1338000,1336738,1262,,1142
MT1232,1338319,1338095,224,,1142
MT1233,1338454,1338786,332,,1142
MT1234,1338836,1340008,1172,,1142
MT1235,1340146,1340439,293,,1142
MT1236,1340493,1340774,281,,1142
MT1237,1342155,1340848,1307,,1142
MT1238,1342429,1343703,1274,,1142
MT1239,1344656,1343706,950,,1139
MT1240,1344747,1345808,1061,,1139
MT1241,1346392,1345811,581,,1139
MT1242,1348111,1346426,1685,,1139
MT1243,1348206,1348766,560,,1139
MT1244,1348819,1350609,1790,,1139
MT1245,1350678,1351631,953,,1139
MT1246,1351631,1352602,971,,1136
MT1247,1352644,1353009,365,,1136
MT1248,1353009,1353620,611,,1136
MT1249,1353685,1353954,269,,1136
MT1250,1355148,1353988,1160,,1136
MT1251,1355323,1356534,1211,,1136
MT1252,1357112,1356783,329,,1133
MT1253,1358931,1357249,1682,,1133
MT1254,1359633,1358962,671,,1133
MT1255,1361288,1359645,1643,,1130
MT1256,1362220,1361288,932,,1130
MT1257,1362848,1362213,635,,1130
MT1258,1363637,1362993,644,,1130
MT1259,1363900,1364670,770,,1127
MT1260,1364636,1365292,656,,1127
MT1261,1365363,1366946,1583,,1127
MT1262,1366951,1367343,392,,1127
MT1263,1368209,1367382,827,,1127
MT1264,1369783,1368323,1460,,1127
MT1264.1,1369768,1370358,590,,1124
MT1265,1370408,1370962,554,,1124
MT1266,1371017,1371187,170,,1124
MT1267,1372437,1371268,1169,,1124
MT1268,1373685,1372453,1232,,1124
MT1269,1374352,1373813,539,,1124
MT1270,1375656,1374352,1304,,1123
MT1271,1376323,1375721,602,,1121
MT1272,1376464,1376988,524,,1121
MT1273,1377012,1378415,1403,,1121
MT1274,1378415,1379335,920,,1121
MT1275,1379343,1380164,821,,1121
MT1276,1380172,1381350,1178,,1121
MT1277,1382530,1381433,1097,,1118
MT1278,1382701,1383687,986,,1118
MT1279,1383730,1384023,293,,1118
MT1280,1384023,1384451,428,,1118
MT1280.1,1386237,1384480,1757,,1118
MT1281,1386345,1387202,857,,1118
MT1283,1388116,1387289,827,,1118
MT1284,1388604,1388176,428,,1118
MT1285,1388630,1388746,116,,1118
MT1286,1392539,1388847,3692,,1115
MT1287,1393469,1392684,785,,1115
MT1288,1393647,1393498,149,,1115
MT1289,1393666,1395402,1736,,1115
MT1290,1398751,1395311,3440,,1115
MT1291,1399391,1398786,605,,1115
MT1292,1399457,1401145,1688,,1115
MT1293,1401145,1402293,1148,,1112
MT1294,1402873,1402268,605,,1112
MT1295,1404090,1402876,1214,,1112
MT1296,1405571,1404207,1364,,1112
MT1297,1406827,1405571,1256,,1112
MT1297.1,1406919,1407722,803,,1112
MT1298,1407694,1408842,1148,,1112
MT1299,1409419,1408973,446,,1109
MT1300,1409894,1409427,467,,1109
MT1301,1409917,1411302,1385,,1109
MT1302,1411380,1412570,1190,,1106
MT1303,1412746,1413423,677,,1106
MT1304,1415326,1413449,1877,,1106
MT1305,1416833,1415670,1163,,1106
MT1305.1,1417183,1416884,299,,1106
MT1306,1417842,1417147,695,,1103
MT1307,1418487,1418068,419,,1103
MT1308,1419234,1418503,731,,1103
MT1309,1419794,1419450,344,,1103
MT1310,1421791,1419899,1892,,1103
MT1311,1423536,1421791,1745,,1103
MT1312,1423668,1424237,569,,1100
MT1312.1,1424189,1424776,587,,1100
MT1313,1425430,1424927,503,,1100
MT1314,1425650,1426900,1250,,1100
MT1315,1426900,1429524,2624,,1100
MT1316,1429548,1431131,1583,,1100
MT1317,1432926,1431154,1772,,1100
MT1318,1434757,1432922,1835,,1097
MT1319,1435629,1434757,872,,1097
MT1320,1436603,1435629,974,,1097
MT1321,1436602,1436745,143,,1093
MT1322,1436810,1437298,488,,1091
MT1323,1437464,1438390,926,,1091
MT1324,1438393,1440234,1841,,1091
MT1325,1440291,1440773,482,,1091
MT1326,1440834,1442201,1367,,1091
MT1327,1442253,1442882,629,,1091
MT1328,1444547,1443027,1520,,1088
MT1329,1444546,1444911,365,,1088
MT1330,1445136,1445044,92,,1088
MT1330.1,1445161,1445703,542,,1088
MT1331,1445920,1447569,1649,,1088
MT1332,1447569,1448909,1340,,1088
MT1333,1448916,1450238,1322,,1088
MT1334,1450238,1451317,1079,,1088
MT1335,1451538,1452485,947,,1085
MT1336,1452745,1454550,1805,,1085
MT1337,1454704,1454943,239,,1085
MT1338,1455036,1456106,1070,,1085
MT1339,1456169,1457080,911,,1085
MT1340,1457099,1457749,650,,1082
MT1341,1457833,1459047,1214,,1082
MT1342,1459212,1459307,95,,1082
MT1343,1459307,1459789,482,,1082
MT1344,1459785,1460534,749,,1079
MT1345,1460586,1460828,242,,1079
MT1346,1460862,1461374,512,,1079
MT1347,1461384,1462721,1337,,1079
MT1348,1462769,1464415,1646,,1079
MT1349,1464425,1465339,914,,1079
MT1350,1465382,1466839,1457,,1079
MT1351,1466856,1467218,362,,1079
MT1352,1467229,1467669,440,,1076
MT1353,1469046,1467715,1331,,1076
MT1354,1469793,1469215,578,,1076
MT1355,1469862,1471115,1253,,1076
MT1356,1473005,1473151,146,,1073
MT1357,1477196,1476678,518,,1073
MT1358,1478659,1477172,1487,,1073
MT1359,1480365,1478743,1622,,1073
MT1360,1482033,1480438,1595,,1073
MT1361,1483716,1482043,1673,,1073
MT1362,1485432,1483732,1700,,1073
MT1363,1485494,1486171,677,,1073
MT1363.1,1486197,1486490,293,,1073
MT1364,1486986,1486531,455,,1070
MT1365,1487077,1488243,1166,,1070
MT1366,1488376,1489287,911,,1070
MT1367,1490975,1489371,1604,,1070
MT1367.1,1491118,1491231,113,,1070
MT1368,1493526,1491334,2192,,1070
MT1369,1495747,1493537,2210,,1070
MT1370,1495778,1498366,2588,,1070
MT1371,1500403,1498412,1991,,1067
MT1372,1501773,1500430,1343,,1067
MT1373,1501875,1502177,302,,1064
MT1374,1502140,1502793,653,,1064
MT1375,1502813,1503844,1031,,1064
MT1376,1503855,1504292,437,,1064
MT1376.1,1504317,1504595,278,,1061
MT1377,1504608,1505576,968,,1061
MT1378,1505609,1506289,680,,1061
MT1379,1506289,1507101,812,,1061
MT1380,1507131,1507949,818,,1061
MT1381,1507969,1508745,776,,1058
MT1382,1508787,1509398,611,,1058
MT1383,1509760,1509401,359,,1058
MT1384,1510137,1509760,377,,1058
MT1385,1510182,1510499,317,,1058
MT1387,1510664,1512058,1394,,1058
MT1388,1512061,1513218,1157,,1058
MT1389,1513820,1513191,629,,1058
MT1390,1514262,1516838,2576,,1055
MT1392,1516838,1518574,1736,,1055
MT1393,1518706,1519446,740,,1055
MT1394,1519446,1519772,326,,1055
MT1395,1519978,1520346,368,,1055
MT1396,1521200,1520418,782,,1055
MT1397,1523091,1521223,1868,,1055
MT1398,1525028,1523103,1925,,1055
MT1399,1526035,1525247,788,,1055
MT1400,1527431,1526511,920,,1052
MT1401,1527591,1527454,137,,1052
MT1402,1527827,1531303,3476,,1052
MT1403,1531379,1532137,758,,1052
MT1404,1532424,1532191,233,,1049
MT1405,1532563,1533582,1019,,1049
MT1406,1534848,1533661,1187,,1046
MT1407,1535825,1535166,659,,1046
MT1408,1536415,1535825,590,,1046
MT1409,1536608,1536387,221,,1046
MT1410,1538944,1536902,2042,,1046
MT1411,1539385,1539002,383,,1046
MT1412,1539606,1540424,818,,1043
MT1413,1540396,1540653,257,,1043
MT1414,1541933,1540731,1202,,1043
MT1414.1,1542039,1542182,143,,1043
MT1415,1542236,1543018,782,,1043
MT1416,1543061,1544683,1622,,1043
MT1417,1544683,1545861,1178,,1043
MT1418,1545888,1546847,959,,1040
MT1418.1,1547388,1546933,455,,1040
MT1419,1547690,1549006,1316,,1040
MT1420,1549006,1550496,1490,,1040
MT1421,1551117,1550440,677,,1037
MT1422,1552513,1551089,1424,,1037
MT1423,1552512,1553090,578,,1037
MT1424,1553090,1554046,956,,1037
MT1425,1554046,1555335,1289,,1037
MT1426,1555335,1555829,494,,1037
MT1427,1555865,1556956,1091,,1037
MT1428,1556959,1560303,3344,,1037
MT1429,1560303,1561124,821,,1037
MT1430,1561322,1561627,305,,1037
MT1431,1561627,1563243,1616,,1037
MT1432,1563552,1563304,248,,1037
MT1433,1563789,1564121,332,,1034
MT1434,1564232,1564882,650,,1034
MT1435,1564882,1565280,398,,1034
MT1436,1565299,1566552,1253,,1034
MT1437,1566674,1567891,1217,,1034
MT1438,1569445,1567970,1475,,1034
MT1439,1570827,1569445,1382,,1034
MT1440,1570905,1571936,1031,,1031
MT1440.1,1573714,1571988,1726,,1031
MT1441,1574370,1573972,398,,1031
MT1442,1574636,1574370,266,,1031
MT1443,1575666,1574710,956,,1031
MT1444,1576653,1575694,959,,1031
MT1445,1576604,1577386,782,,1031
MT1446,1577470,1579431,1961,,1031
MT1447,1580276,1579455,821,,1031
MT1448,1580400,1580924,524,,1031
MT1449,1581823,1581002,821,,1031
MT1450,1582020,1582955,935,,1031
MT1451,1582955,1584325,1370,,1031
MT1452,1584362,1585048,686,,1028
MT1453,1585048,1586064,1016,,1028
MT1454,1587620,1586067,1553,,1028
MT1455,1588345,1587629,716,,1028
MT1456,1588421,1589023,602,,1028
MT1457,1589376,1590143,767,,1028
MT1458,1590251,1591525,1274,,1028
MT1459,1591525,1592004,479,,1025
MT1460,1592004,1592465,461,,1025
MT1461,1592493,1593176,683,,1025
MT1462,1593359,1593829,470,,1025
MT1463,1593896,1595833,1937,,1025
MT1464,1595833,1596735,902,,1025
MT1465,1596735,1597760,1025,,1025
MT1466,1597754,1598734,980,,1022
MT1467,1599091,1598750,341,,1022
MT1468,1599074,1600888,1814,,1022
MT1469,1602176,1600764,1412,,1022
MT1470,1603783,1602179,1604,,1022
MT1471,1604614,1603790,824,,1022
MT1472,1604733,1605998,1265,,1022
MT1474,1606242,1607825,1583,,1019
MT1475,1607939,1609705,1766,,1019
MT1476,1609705,1611123,1418,,1019
MT1477,1611290,1612102,812,,1019
MT1478,1612112,1612252,140,,1019
MT1479,1612866,1612207,659,,1019
MT1479.1,1612811,1613023,212,,1019
MT1480,1613190,1614206,1016,,1019
MT1481,1614212,1615447,1235,,1019
MT1482,1615447,1616229,782,,1016
MT1483,1616836,1616251,585,,1016
MT1484,1617269,1616847,422,,1016
MT1485,1617720,1617950,230,,1016
MT1486,1619566,1618095,1471,,1013
MT1487,1619673,1621970,2297,,1013
MT1488,1622089,1621973,116,,1013
MT1489,1622574,1622092,482,,1013
MT1490,1622638,1622886,248,,1013
MT1491,1623579,1623172,407,,1013
MT1492,1624339,1623599,740,,1013
MT1493,1625247,1624339,908,,1013
MT1494,1626844,1625303,1541,,1013
MT1495,1627962,1626844,1118,,1010
MT1496,1630156,1627982,2174,,1010
MT1497.1,1634745,1630522,4223,,1010
MT1497.2,1635094,1634939,155,,1010
MT1498,1635144,1636067,923,,1007
MT1499,1638335,1636122,2213,,1007
MT1500,1638451,1639746,1295,,1007
MT1501,1640784,1639780,1004,,1007
MT1502,1640744,1641643,899,,1007
MT1503,1642531,1641599,932,,1007
MT1504,1643425,1642643,782,,1007
MT1505,1644363,1643425,938,,1006
MT1506,1646294,1644522,1772,,1004
MT1507,1646312,1647145,833,,1004
MT1508,1647145,1649682,2537,,1004
MT1509,1649682,1650872,1190,,1004
MT1510,1650872,1651669,797,,1004
MT1511,1651674,1652924,1250,,1004
MT1512,1652924,1653409,485,,1004
MT1513,1653387,1653731,344,,1004
MT1514,1655658,1653832,1826,,1001
MT1514.1,1656892,1655768,1124,,1001
MT1515,1657119,1659089,1970,,1001
MT1516,1659136,1659507,371,,1001
MT1517,1659526,1659894,368,,1001
MT1518,1659919,1660773,854,,1001
MT1519,1660812,1662437,1625,,1001
MT1520,1662537,1662725,188,,998
MT1521,1663360,1662800,560,,998
MT1522,1666202,1663374,2828,,998
MT1523,1666360,1666917,557,,998
MT1524,1667737,1668561,824,,998
MT1525,1668575,1669297,722,,995
MT1526,1669439,1670569,1130,,995
MT1527,1670611,1671519,908,,995
MT1528,1671533,1672537,1004,,995
MT1529,1673491,1672616,875,,995
MT1530,1673596,1674336,740,,992
MT1531,1674358,1675164,806,,992
MT1532,1675173,1676204,1031,,992
MT1533,1677039,1676176,863,,992
MT1533.1,1677097,1677528,431,,992
MT1533.2,1677553,1678695,1142,,992
MT1534,1678708,1679061,353,,992
MT1535,1679098,1679325,227,,989
MT1536,1679478,1680782,1304,,989
MT1537,1680883,1681143,260,,989
MT1538,1682122,1681367,755,,989
MT1539,1682313,1684157,1844,,989
MT1540,1684161,1686410,2249,,986
MT1541,1686427,1686726,299,,986
MT1542,1686726,1687040,314,,986
MT1543,1687040,1688041,1001,,986
MT1545,1688100,1689383,1283,,986
MT1546,1690076,1689462,614,,986
MT1547,1690502,1690293,209,,986
MT1548,1690491,1690958,467,,986
MT1549,1691006,1692031,1025,,986
MT1550,1692046,1692864,818,,983
MT1551,1693080,1693976,896,,983
MT1552,1695318,1694155,1163,,983
MT1553,1696102,1695440,662,,983
MT1554,1696617,1696102,515,,983
MT1555,1697578,1696886,692,,980
MT1555.1,1697512,1698012,500,,980
MT1556,1700050,1698254,1796,,980
MT1556.1,1700364,1700227,137,,980
MT1557,1700368,1701246,878,,980
MT1558,1701451,1701966,515,,980
MT1560,1701978,1702745,767,,980
MT1560.1,1702752,1703168,416,,980
MT1561,1703205,1704248,1043,,977
MT1562,1704200,1705213,1013,,977
MT1563,1705213,1705941,728,,977
MT1564,1706750,1705965,785,,977
MT1565,1707771,1706788,983,,977
MT1566,1708805,1707687,1118,,977
MT1567,1709026,1709787,761,,974
MT1568,1709799,1710755,956,,974
MT1569,1710888,1711154,266,,974
MT1570,1711150,1712220,1070,,974
MT1571,1712412,1712215,197,,974
MT1572,1712457,1714205,1748,,974
MT1573,1717767,1714330,3437,,974
MT1574,1717898,1718848,950,,971
MT1575,1718881,1720122,1241,,971
MT1576,1720172,1720954,782,,971
MT1577,1722215,1720938,1277,,971
MT1578,1728539,1722241,6298,,971
MT1578.1,1728784,1728912,128,,971
MT1579,1729604,1729110,494,,971
MT1580,1729656,1731407,1751,,971
MT1581,1731527,1732627,1100,,971
MT1582,1732627,1733190,563,,971
MT1583,1733704,1733273,431,,968
MT1584,1733764,1734887,1123,,968
MT1585,1734887,1735561,674,,968
MT1585.1,1735761,1735925,164,,968
MT1586,1736129,1736362,233,,968
MT1587,1736672,1739794,3122,,968
MT1589,1739943,1741397,1454,,968
MT1590,1742345,1741368,977,,968
MT1591,1742397,1743002,605,,968
MT1592,1742998,1743921,923,,968
MT1593,1744524,1743934,590,,965
MT1594,1744989,1744582,407,,965
MT1595,1745340,1746239,899,,965
MT1596,1746247,1747047,800,,965
MT1596.1,1747072,1747296,224,,965
MT1597,1747348,1747776,428,,965
MT1598,1747847,1751398,3551,,965
MT1599,1753732,1751453,2279,,965
MT1600,1753870,1755582,1712,,962
MT1601,1755671,1757461,1790,,962
MT1602,1757849,1757565,284,,962
MT1603,1757835,1759583,1748,,962
MT1604,1759589,1760329,740,,962
MT1605,1760329,1760706,377,,962
MT1606,1760706,1761080,374,,962
MT1607,1761151,1761756,605,,959
MT1608,1761898,1763088,1190,,959
MT1609,1763101,1763544,443,,959
MT1610,1763582,1764868,1286,,959
MT1611,1764909,1765124,215,,959
MT1612,1765133,1765534,401,,956
MT1613,1767383,1765557,1826,,956
MT1614,1769586,1767292,2294,,956
MT1615,1771755,1769593,2162,,956
MT1616,1773983,1771797,2186,,956
MT1617,1774831,1774085,746,,956
MT1618,1775298,1775017,281,,953
MT1619,1775546,1776856,1310,,953
MT1620,1776856,1778013,1157,,953
MT1621,1778013,1778690,677,,953
MT1622,1778693,1779199,506,,953
MT1622.1,1780070,1779351,719,,953
MT1623,1780743,1780078,665,,953
MT1624,1781191,1782237,1046,,953
MT1625,1782241,1782477,236,,953
MT1626,1782561,1783139,578,,953
MT1627,1783298,1783200,98,,953
MT1628,1784674,1783310,1364,,950
MT1629,1785437,1784907,530,,950
MT1630,1785663,1786709,1046,,950
MT1631,1786712,1788292,1580,,950
MT1632,1788265,1789149,884,,950
MT1633,1789201,1789956,755,,950
MT1634,1790390,1789983,407,,950
MT1635,1790463,1791803,1340,,950
MT1636,1791803,1792942,1139,,950
MT1637,1792942,1793571,629,,950
MT1638,1793571,1794188,617,,947
MT1639,1794204,1794935,731,,947
MT1640,1794946,1795755,809,,947
MT1641,1795760,1796560,800,,947
MT1641.1,1796560,1796904,344,,947
MT1642,1797088,1798167,1079,,947
MT1643,1798669,1798208,461,,947
MT1644,1798810,1800357,1547,,947
MT1645,1800350,1801054,704,,947
MT1646,1801117,1801962,845,,947
MT1647,1801998,1803263,1265,,947
MT1648,1803266,1804075,809,,944
MT1649,1804078,1805481,1403,,944
MT1650,1805590,1805438,152,,944
MT1650.1,1805945,1805655,290,,944
MT1651,1806160,1806597,437,,944
MT1652,1806590,1806985,395,,941
MT1653,1807096,1808511,1415,,941
MT1654,1808540,1809421,881,,941
MT1655,1809482,1810933,1451,,941
MT1656,1812600,1810873,1727,,941
MT1657,1814180,1812600,1580,,941
MT1658,1815307,1814270,1037,,941
MT1659,1816794,1815340,1454,,941
MT1660,1817492,1816908,584,,941
MT1661,1818852,1817524,1328,,941
MT1662,1819078,1819701,623,,941
MT1663,1820980,1819775,1205,,938
MT1664,1821468,1820980,488,,938
MT1665,1821572,1824283,2711,,938
MT1666,1824449,1825891,1442,,938
MT1667,1825920,1827140,1220,,935
MT1668,1827737,1827297,440,,935
MT1669,1827859,1830075,2216,,935
MT1670,1830075,1831487,1412,,935
MT1671,1833176,1831482,1694,,935
MT1672,1833358,1833795,437,,935
MT1673,1834599,1833808,791,,935
MT1675,1834624,1837563,2939,,935
MT1676,1837880,1837626,254,,932
MT1677,1839365,1837899,1466,,932
MT1678,1842981,1839427,3554,,932
MT1679,1843231,1843782,551,,932
MT1680,1843835,1844026,191,,932
MT1681,1844091,1844477,386,,932
MT1682,1844513,1845292,779,,932
MT1683,1846361,1845309,1052,,932
MT1684,1846671,1847600,929,,932
MT1685,1847648,1848628,980,,932
MT1686,1848638,1849441,803,,929
MT1687,1849640,1850662,1022,,929
MT1688,1850665,1853157,2492,,929
MT1689,1856289,1853257,3032,,929
MT1690,1856483,1857538,1055,,929
MT1691,1857538,1858749,1211,,929
MT1692,1858749,1859630,881,,929
MT1693,1859630,1860829,1199,,929
MT1694,1860829,1861749,920,,929
MT1695,1861749,1862351,602,,929
MT1696,1862269,1863462,1193,,929
MT1697,1863545,1864954,1409,,926
MT1698,1865066,1866124,1058,,926
MT1701,1866210,1872587,6377,,926
MT1702,1872610,1877415,4805,,926
MT1703,1877418,1878923,1505,,926
MT1704,1878932,1881982,3050,,925
MT1705,1882132,1883190,1058,,924
MT1706,1884486,1883179,1307,,924
MT1707,1886258,1884486,1772,,923
MT1707.1,1886737,1886886,149,,923
MT1708,1886922,1887266,344,,923
MT1709,1887211,1887666,455,,923
MT1710,1889009,1887681,1328,,923
MT1711,1890034,1889105,929,,923
MT1712,1890718,1890065,653,,923
MT1713,1890717,1891046,329,,923
MT1714,1891777,1891046,731,,923
MT1715,1891978,1892550,572,,923
MT1716,1892550,1893095,545,,923
MT1717,1893095,1893193,98,,920
MT1718,1893193,1894098,905,,920
MT1719,1894101,1895219,1118,,920
MT1720,1895231,1896052,821,,920
MT1721,1896049,1897041,992,,920
MT1722,1897274,1898119,845,,920
MT1723,1898324,1901392,3068,,920
MT1724,1901388,1901609,221,,920
MT1725,1902201,1901581,620,,917
MT1726,1902883,1902206,677,,917
MT1727,1903722,1902958,764,,917
MT1727.1,1903781,1904389,608,,917
MT1728,1904404,1905675,1271,,917
MT1729,1906329,1906709,380,,917
MT1730,1906751,1907500,749,,914
MT1731,1907500,1908558,1058,,914
MT1732,1908558,1908731,173,,914
MT1733,1908742,1909545,803,,914
MT1734,1909548,1910468,920,,911
MT1735,1910485,1912245,1760,,911
MT1736,1912344,1913522,1178,,911
MT1737,1913532,1914488,956,,911
MT1738,1914631,1916388,1757,,911
MT1739,1916384,1917004,620,,911
MT1740,1917004,1917936,932,,911
MT1741,1919377,1918016,1361,,911
MT1742,1919658,1919870,212,,911
MT1743,1920634,1919936,698,,911
MT1744,1922258,1920591,1667,,911
MT1745,1923456,1922302,1154,,911
MT1746,1924680,1923499,1181,,911
MT1746.1,1925135,1925296,161,,911
MT1747,1925487,1925287,200,,910
MT1748,1925684,1927141,1457,,908
MT1749,1927366,1928115,749,,908
MT1750,1928115,1928948,833,,908
MT1751,1928948,1929640,692,,908
MT1751.1,1929640,1930401,761,,908
MT1752,1930401,1931090,689,,908
MT1753,1931090,1932478,1388,,908
MT1753.1,1932655,1933464,809,,908
MT1754,1933461,1934372,911,,908
MT1755,1934378,1935205,827,,908
MT1756,1935208,1935555,347,,908
MT1757,1936573,1935416,1157,,905
MT1758,1936443,1937219,776,,905
MT1759,1937219,1937323,104,,905
MT1760,1937662,1937781,119,,905
MT1761,1938221,1937835,386,,905
MT1762,1938445,1938221,224,,905
MT1763,1938663,1940144,1481,,905
MT1764,1940144,1941388,1244,,905
MT1765,1941853,1941437,416,,905
MT1766,1942406,1941846,560,,905
MT1767,1942653,1944035,1382,,905
MT1768,1944071,1944637,566,,905
MT1769,1945441,1944668,773,,905
MT1770,1946370,1945435,935,,905
MT1771,1948169,1946553,1616,,902
MT1771.1,1948124,1948240,116,,902
MT1772,1948535,1950088,1553,,902
MT1773,1950649,1950104,545,,902
MT1774,1951309,1950716,593,,902
MT1775,1951539,1951892,353,,902
MT1776,1952742,1952152,590,,902
MT1777,1952987,1952748,239,,899
MT1778,1955044,1953089,1955,,899
MT1779,1956228,1955044,1184,,899
MT1780,1956338,1956796,458,,899
MT1781,1958495,1956816,1679,,899
MT1782,1958563,1958772,209,,899
MT1783,1958775,1959020,245,,899
MT1784,1959031,1959765,734,,899
MT1785,1959862,1961559,1697,,899
MT1786,1962308,1961850,458,,899
MT1787,1962849,1962241,608,,899
MT1788,1962996,1964423,1427,,899
MT1789,1964494,1967082,2588,,899
MT1790,1967282,1967374,92,,899
MT1791,1967458,1968186,728,,899
MT1792,1968743,1968189,554,,896
MT1793,1970425,1968830,1595,,896
MT1794,1970623,1971858,1235,,896
MT1795,1971988,1972434,446,,896
MT1796,1975789,1972475,3314,,896
MT1797,1977684,1975996,1688,,896
MT1798,1977722,1977868,146,,893
MT1799,1979412,1977871,1541,,893
MT1800,1980686,1979544,1142,,893
MT1801,1980876,1982012,1136,,890
MT1802,1982216,1985050,2834,,890
MT1803,1986451,1985570,881,,890
MT1804,1986828,1986505,323,,890
MT1805,1986864,1987385,521,,890
MT1807,1990398,1987658,2740,,890
MT1808,1990560,1990790,230,,887
MT1809,1990887,1992479,1592,,887
MT1810,1992875,1992495,380,,887
MT1811,1993663,1992878,785,,887
MT1812,1994270,1993806,464,,887
MT1813,1994520,1994371,149,,887
MT1814,1995937,1994684,1253,,887
MT1814.2,1995998,1996348,350,,884
MT1815,1996956,1996351,605,,884
MT1816,1997159,1997425,266,,884
MT1817,1997496,1997852,356,,884
MT1818,1998036,1999887,1851,,884
MT1820,2000088,2001287,1199,,884
MT1820.1,2001298,2002581,1283,,884
MT1821,2002581,2003864,1283,,884
MT1821.1,2004229,2004065,164,,884
MT1822,2004397,2004263,134,,884
MT1823,2005219,2004443,776,,884
MT1824,2005252,2006589,1337,,881
MT1825,2006592,2007407,815,,881
MT1826,2007975,2007418,557,,881
MT1827,2008076,2009377,1301,,881
MT1828,2010007,2009504,503,,881
MT1829,2011899,2010109,1790,,881
MT1830,2012119,2012679,560,,881
MT1831,2014896,2012725,2171,,881
MT1832,2015160,2016677,1517,,881
MT1833,2016677,2020849,4172,,881
MT1834,2022147,2020870,1277,,881
MT1835,2022248,2022448,200,,881
MT1836,2022601,2023815,1214,,881
MT1837,2023897,2024193,296,,881
MT1838,2024156,2025388,1232,,881
MT1838.1,2025431,2025730,299,,878
MT1839,2025806,2026894,1088,,878
MT1839.1,2027010,2026846,164,,878
MT1840,2027306,2027620,314,,878
MT1841,2027767,2028060,293,,878
MT1842,2028114,2028395,281,,878
MT1843,2028486,2029385,899,,875
MT1844,2029660,2031168,1508,,875
MT1845,2031149,2032903,1754,,875
MT1846,2032903,2034120,1217,,875
MT1847,2034120,2035949,1829,,875
MT1848,2036579,2036767,188,,875
MT1849,2036873,2038837,1964,,875
MT1849.1,2039177,2038794,383,,875
MT1850,2039421,2040689,1268,,875
MT1851,2040804,2042192,1388,,874
MT1853,2044295,2042346,1949,,872
MT1854,2044811,2044446,365,,872
MT1854.1,2045529,2045110,419,,872
MT1855,2045492,2045788,296,,872
MT1856,2045806,2047014,1208,,872
MT1856.1,2047410,2048567,1157,,872
MT1857,2048024,2050105,2081,,872
MT1858,2050302,2050706,404,,872
MT1859,2050863,2051564,701,,872
MT1860,2052770,2051580,1190,,872
MT1861,2053532,2053104,428,,869
MT1862,2053899,2054840,941,,869
MT1863,2054948,2055610,662,,869
MT1864,2055676,2056377,701,,869
MT1865,2057015,2058412,1397,,866
MT1866,2060071,2058599,1472,,866
MT1867,2062065,2060149,1916,,866
MT1868,2062136,2063776,1640,,866
MT1869,2063794,2066217,2423,,866
MT1870,2066417,2067043,626,,866
MT1871,2067033,2067959,926,,866
MT1872,2067991,2068353,362,,865
MT1873,2068373,2069248,875,,863
MT1874,2069289,2069690,401,,863
MT1875,2069933,2070418,485,,863
MT1876,2070418,2071158,740,,863
MT1877,2071280,2071771,491,,863
MT1879,2072066,2072740,674,,863
MT1880,2073102,2075924,2822,,863
MT1881,2077014,2076157,857,,863
MT1882,2077055,2077918,863,,863
MT1883,2079813,2077929,1884,,860
MT1884,2081862,2079832,2030,,860
MT1885,2084207,2081985,2222,,860
MT1886,2084878,2084486,392,,860
MT1887,2085138,2084878,260,,860
MT1888,2086744,2085200,1544,,860
MT1889,2087944,2086910,1034,,860
MT1890,2089311,2087947,1364,,860
MT1891,2090924,2089488,1436,,860
MT1892,2092408,2090960,1448,,860
MT1893,2093388,2092441,947,,860
MT1894,2093819,2093406,413,,857
MT1895,2094097,2094516,419,,857
MT1896,2094568,2094867,299,,857
MT1897,2094867,2095178,311,,857
MT1898,2095181,2096911,1730,,857
MT1899,2096914,2097546,632,,857
MT1900,2097560,2098231,671,,857
MT1901,2098188,2098865,677,,857
MT1902,2100262,2098874,1388,,857
MT1903,2101327,2100407,920,,857
MT1904,2102043,2101369,674,,857
MT1905,2102205,2102987,782,,857
MT1906,2103050,2103784,734,,857
MT1907,2103794,2104900,1106,,857
MT1908,2104956,2105930,974,,854
MT1909,2106284,2106171,113,,854
MT1910,2106385,2106687,302,,854
MT1911,2106762,2107802,1040,,854
MT1912,2108582,2107815,767,,854
MT1913,2109276,2108578,698,,854
MT1914,2110187,2109330,857,,851
MT1915,2110283,2112694,2411,,851
MT1916,2114514,2112835,1679,,851
MT1917,2114568,2116664,2096,,851
MT1918,2117916,2116684,1232,,851
MT1919,2118651,2118019,632,,851
MT1920,2119105,2118719,386,,851
MT1921,2120372,2119131,1241,,851
MT1922,2120362,2120829,467,,851
MT1923,2120887,2121588,701,,851
MT1924,2121602,2122042,440,,848
MT1924.1,2122269,2122054,215,,848
MT1925,2122561,2123037,476,,848
MT1926,2123125,2125185,2060,,848
MT1927,2125243,2126592,1349,,845
MT1928,2126598,2127731,1133,,845
MT1929,2129051,2127765,1286,,845
MT1930,2129592,2129131,461,,845
MT1931,2130425,2129595,830,,845
MT1931.1,2130929,2130456,473,,845
MT1932,2131534,2130971,563,,845
MT1933,2132109,2131513,596,,845
MT1934,2133250,2132129,1121,,845
MT1935,2133479,2134633,1154,,845
MT1936,2135571,2134609,962,,842
MT1937,2136263,2135910,353,,842
MT1940,2136933,2136325,608,,842
MT1941,2136987,2137391,404,,842
MT1942,2137411,2137719,308,,842
MT1943,2137732,2137947,215,,842
MT1944,2139115,2137988,1127,,842
MT1945,2139188,2139616,428,,839
MT1946,2139767,2140918,1151,,839
MT1947,2141692,2140784,908,,839
MT1948,2142182,2141700,482,,839
MT1949,2142186,2142491,305,,839
MT1950,2143584,2142463,1121,,839
MT1951,2144924,2143539,1385,,839
MT1952,2144941,2146242,1301,,839
MT1953,2147523,2146300,1223,,839
MT1954,2147556,2148056,500,,839
MT1955,2148242,2148673,431,,839
MT1956,2149686,2148727,959,,839
MT1957,2150189,2149719,470,,839
MT1957.1,2150265,2150531,266,,839
MT1958,2151173,2150529,644,,836
MT1959,2153402,2151183,2219,,836
MT1960,2153892,2153443,449,,836
MT1961,2154626,2154000,626,,836
MT1962,2155290,2154676,614,,833
MT1963,2156382,2155381,1001,,833
MT1964,2156482,2157231,749,,833
MT1965,2157619,2157215,404,,833
MT1966,2157754,2159583,1829,,833
MT1967,2159601,2160050,449,,833
MT1968,2164698,2160226,4472,,833
MT1969,2168044,2165006,3038,,833
MT1970,2168900,2168418,482,,830
MT1971,2168977,2169837,860,,830
MT1972,2171149,2169881,1268,,830
MT1973,2171421,2172533,1112,,830
MT1974,2172587,2173864,1277,,830
MT1975,2174374,2173907,467,,830
MT1976,2174441,2176300,1859,,827
MT1977,2176790,2176314,476,,827
MT1978,2177012,2176923,89,,827
MT1979,2177024,2177797,773,,827
MT1980,2178549,2177807,742,,827
MT1980.1,2179237,2178597,640,,827
MT1980.2,2179773,2179252,521,,827
MT1981,2180582,2179794,788,,827
MT1982,2180703,2181197,494,,827
MT1983,2182288,2181200,1088,,827
MT1984,2183519,2182293,1226,,827
MT1985,2184490,2183537,953,,827
MT1986,2184715,2185821,1106,,827
MT1987,2185827,2188343,2516,,824
MT1988,2188358,2189425,1067,,824
MT1989,2189425,2189937,512,,824
MT1990,2189937,2190995,1058,,824
MT1991,2190995,2191762,767,,824
MT1992,2192328,2191978,350,,824
MT1993,2192678,2192304,374,,824
MT1994,2193265,2192678,587,,824
MT1995,2193236,2194681,1445,,824
MT1997,2195291,2194842,449,,824
MT1998,2195355,2195753,398,,824
MT1998.1,2196395,2196048,347,,824
MT1999,2197308,2196409,899,,824
MT2000,2197520,2197332,188,,824
MT2001,2197934,2197524,410,,824
MT2002,2198045,2198269,224,,821
MT2003,2198269,2198577,308,,821
MT2004,2198915,2199424,509,,821
MT2005,2199469,2199915,446,,821
MT2006,2199915,2200457,542,,821
MT2007,2200517,2200666,149,,821
MT2008,2201308,2201015,293,,821
MT2009,2201556,2201308,248,,821
MT2010,2201543,2202034,491,,821
MT2011,2202037,2202141,104,,818
MT2012,2202604,2202200,404,,818
MT2013,2202880,2202611,269,,818
MT2014,2204133,2202916,1217,,818
MT2015,2204245,2204111,134,,818
MT2015.1,2204804,2204355,449,,818
MT2015.2,2204769,2205035,266,,818
MT2016,2205032,2205826,794,,818
MT2017,2205839,2206651,812,,818
MT2018,2206659,2207933,1274,,818
MT2019,2207933,2208958,1025,,818
MT2020,2208868,2210187,1319,,818
MT2021,2210187,2211455,1268,,818
MT2022,2211455,2212585,1130,,818
MT2023,2212589,2213899,1310,,815
MT2024,2213924,2214496,572,,815
MT2024.1,2214496,2214975,479,,815
MT2025,2214991,2215365,374,,815
MT2026,2215384,2216046,662,,815
MT2027,2216179,2216060,119,,815
MT2028,2216583,2216179,404,,815
MT2029,2217086,2218129,1043,,815
MT2030,2218204,2219085,881,,812
MT2031,2220496,2219054,1442,,812
MT2032,2221490,2220678,812,,812
MT2033,2222520,2221555,965,,812
MT2034,2223164,2222748,416,,812
MT2035,2223433,2223176,257,,812
MT2036,2223576,2225249,1673,,812
MT2037,2225893,2225243,650,,812
MT2038,2226008,2226235,227,,812
MT2039,2227234,2226326,908,,809
MT2040,2227343,2227939,596,,809
MT2041,2228358,2228783,425,,809
MT2042,2229012,2229548,536,,809
MT2042.1,2229731,2230000,269,,809
MT2043,2230631,2230074,557,,809
MT2044,2230969,2230631,338,,809
MT2045,2231055,2231309,254,,809
MT2045.1,2231548,2231216,332,,809
MT2046,2231981,2231640,341,,806
MT2047,2232223,2231978,245,,806
MT2048,2234638,2232326,2312,,806
MT2049,2234907,2234638,269,,806
MT2050,2235316,2234963,353,,806
MT2051,2235473,2236237,764,,806
MT2052,2236336,2237286,950,,806
MT2053,2237503,2240205,2702,,803
MT2054,2241053,2240280,773,,803
MT2055,2242470,2241151,1319,,803
MT2056,2242523,2244151,1628,,803
MT2057,2244164,2244913,749,,803
MT2058,2244992,2245771,779,,803
MT2059,2246752,2245898,854,,803
MT2060,2248318,2246813,1505,,803
MT2061,2249215,2248331,884,,803
MT2062,2249334,2253314,3980,,803
MT2063,2253760,2253419,341,,803
MT2064,2255307,2253952,1355,,803
MT2064.1,2255362,2255601,239,,803
MT2065,2255605,2256000,395,,800
MT2066,2256617,2256189,428,,800
MT2067,2256658,2257149,491,,800
MT2068,2257149,2257394,245,,800
MT2069,2257856,2258473,617,,800
MT2070,2258430,2259017,587,,797
MT2071,2260443,2259151,1292,,797
MT2072,2260692,2261330,638,,797
MT2073,2261330,2262367,1037,,797
MT2074,2262543,2263328,785,,797
MT2075,2263321,2263734,413,,797
MT2076,2264052,2263756,296,,797
MT2077,2264442,2264140,302,,797
MT2078,2265056,2264454,602,,797
MT2079,2265536,2265084,452,,797
MT2080,2266277,2265603,674,,797
MT2080.1,2266465,2266232,233,,794
MT2081,2267607,2266675,932,,794
MT2082,2272572,2267755,4817,,794
MT2083,2272895,2272782,113,,794
MT2084,2274080,2273085,995,,794
MT2085,2275079,2274198,881,,794
MT2086,2276840,2275122,1718,,794
MT2087,2277740,2276904,836,,794
MT2088,2278756,2277740,1016,,794
MT2089,2280818,2278776,2042,,794
MT2090,2281264,2280833,431,,794
MT2091,2281455,2282453,998,,794
MT2092,2282562,2282443,119,,794
MT2093,2283414,2282575,839,,791
MT2094,2283479,2283946,467,,791
MT2095,2283946,2284431,485,,791
MT2096,2284377,2285069,692,,791
MT2097,2286053,2285082,971,,791
MT2098,2287128,2286058,1070,,791
MT2099,2287973,2287134,839,,791
MT2100,2288862,2287963,899,,788
MT2101,2290178,2288862,1316,,788
MT2102,2291013,2290219,794,,788
MT2103,2291573,2291016,557,,788
MT2104,2292003,2291617,386,,788
MT2105,2293522,2292020,1502,,788
MT2106,2293601,2294254,653,,788
MT2107,2296858,2294297,2561,,788
MT2108,2309318,2296866,12452,,788
MT2109,2309987,2309628,359,,788
MT2110,2310153,2310485,332,,785
MT2111,2313069,2310466,2603,,785
MT2112,2314849,2313248,1601,,785
MT2113,2314830,2315405,575,,785
MT2114,2315457,2316167,710,,785
MT2115,2316428,2316309,119,,785
MT2116,2316685,2316422,263,,785
MT2117,2316991,2316689,302,,785
MT2117.1,2317157,2316996,161,,785
MT2118,2317393,2317160,233,,785
MT2119,2317506,2319038,1532,,785
MT2120,2319456,2319016,440,,785
MT2121,2323088,2319504,3584,,785
MT2122,2323163,2323393,230,,785
MT2123,2323473,2323796,323,,785
MT2124,2323783,2324871,1088,,785
MT2125,2324884,2325507,623,,785
MT2126,2325507,2327030,1523,,782
MT2127,2328202,2326982,1220,,782
MT2128,2329141,2328221,920,,782
MT2129,2328898,2329830,932,,782
MT2130,2330557,2329826,731,,782
MT2131,2331354,2330557,797,,782
MT2132,2332478,2331309,1169,,782
MT2133,2333295,2332549,746,,782
MT2134,2333325,2333735,410,,782
MT2135,2335211,2333751,1460,,782
MT2136,2335668,2335372,296,,782
MT2137,2336626,2335658,968,,782
MT2138,2336926,2336630,296,,782
MT2138.1,2337060,2337206,146,,782
MT2138.2,2337627,2337187,440,,782
MT2139,2337391,2337702,311,,779
MT2140,2337687,2339654,1967,,779
MT2141,2339629,2340198,569,,779
MT2142,2340370,2340179,191,,779
MT2143,2340849,2340400,449,,779
MT2144,2341041,2343197,2156,,779
MT2145,2343197,2344138,941,,779
MT2146,2344128,2345267,1139,,779
MT2147,2345353,2345655,302,,776
MT2148,2345637,2346547,910,,776
MT2149,2346737,2348503,1766,,776
MT2150,2349650,2348526,1124,,776
MT2151,2349866,2350819,953,,776
MT2152,2351560,2350829,731,,776
MT2153,2354322,2351605,2717,,776
MT2154,2355224,2354373,851,,776
MT2155,2355660,2355316,344,,776
MT2156,2356582,2355635,947,,773
MT2157,2357577,2356582,995,,773
MT2158,2358944,2357589,1355,,773
MT2159,2360471,2358999,1472,,773
MT2160,2360651,2362303,1652,,773
MT2160.1,2362469,2362636,167,,773
MT2161,2362683,2365544,2861,,773
MT2162,2365540,2366370,830,,773
MT2163,2366789,2366355,434,,770
MT2164,2367047,2366796,251,,770
MT2165,2367359,2367066,293,,770
MT2165.1,2368117,2368022,95,,770
MT2166,2368267,2368560,293,,770
MT2167,2368619,2369347,728,,770
MT2168,2369639,2369764,125,,770
MT2169,2370636,2369893,743,,770
MT2170,2371508,2370636,872,,770
MT2171,2371699,2371508,191,,767
MT2172,2373329,2371815,1514,,767
MT2173,2373480,2374670,1190,,767
MT2174,2374645,2375304,659,,767
MT2175,2377140,2375314,1826,,767
MT2176,2377421,2377987,566,,767
MT2177,2377998,2378288,290,,767
MT2178,2379162,2378323,839,,767
MT2179,2379236,2380069,833,,767
MT2180,2380610,2380098,512,,767
MT2181,2381510,2380659,851,,767
MT2182,2381794,2381516,278,,767
MT2182.1,2381921,2382370,449,,767
MT2183,2384580,2382139,2441,,764
MT2184,2384869,2385744,875,,764
MT2185,2386235,2385747,488,,764
MT2185.1,2386846,2386547,299,,764
MT2186,2387272,2388657,1385,,761
MT2187,2389815,2388886,929,,761
MT2188,2390917,2389793,1124,,761
MT2189,2391799,2391095,704,,761
MT2190,2391968,2392213,245,,761
MT2191,2393214,2392429,785,,761
MT2192,2393812,2393228,584,,761
MT2193,2394586,2393879,707,,761
MT2194,2395431,2394586,845,,761
MT2195,2395890,2395480,410,,761
MT2196,2395905,2396978,1073,,758
MT2197,2397295,2398365,1070,,758
MT2198,2398903,2398376,527,,758
MT2199,2400297,2398954,1343,,758
MT2200,2401201,2400887,314,,758
MT2201,2401413,2401201,212,,755
MT2202,2401668,2402723,1055,,755
MT2203,2403212,2402859,353,,755
MT2204,2404089,2403310,779,,755
MT2205,2404743,2404360,383,,755
MT2206,2405534,2404812,722,,755
MT2207,2406325,2405534,791,,755
MT2208,2407119,2406316,803,,755
MT2209,2408281,2407079,1202,,755
MT2210,2409332,2408391,941,,755
MT2211,2410813,2409332,1481,,755
MT2212,2412042,2410813,1229,,752
MT2213,2413613,2412042,1571,,752
MT2214,2415115,2413628,1487,,752
MT2215,2416166,2415090,1076,,752
MT2216,2417695,2416166,1529,,752
MT2217,2419437,2417695,1742,,752
MT2218,2420356,2419325,1031,,752
MT2218.1,2420694,2420356,338,,752
MT2219,2421828,2420965,863,,749
MT2220,2423529,2421934,1595,,749
MT2221,2425778,2423742,2036,,749
MT2222,2426929,2425778,1151,,749
MT2223,2427960,2426929,1031,,749
MT2224,2428549,2428121,428,,749
MT2225,2429302,2428901,401,,749
MT2226,2429568,2430185,617,,749
MT2227,2430242,2430964,722,,749
MT2228,2431944,2430967,977,,749
MT2229,2432180,2433235,1055,,749
MT2230,2433242,2434789,1547,,749
MT2231,2435243,2434782,461,,746
MT2232,2435274,2436470,1196,,746
MT2233,2437280,2436618,662,,746
MT2234,2439053,2437668,1385,,746
MT2234.1,2439650,2439147,503,,746
MT2235,2440598,2439663,935,,746
MT2236,2440635,2441915,1280,,743
MT2237,2442662,2441922,740,,743
MT2238,2443152,2442751,401,,743
MT2239,2444282,2443143,1139,,743
MT2240,2444833,2444402,431,,743
MT2241,2445327,2444941,386,,743
MT2242,2445484,2447292,1808,,743
MT2243,2448483,2447329,1154,,743
MT2244,2449353,2448583,770,,743
MT2245,2450662,2449451,1211,,743
MT2246,2451069,2450794,275,,743
MT2247,2451176,2453086,1910,,743
MT2248,2454007,2452967,1040,,742
MT2249,2454234,2454842,608,,740
MT2250,2454886,2455725,839,,740
MT2251,2455725,2457011,1286,,740
MT2252,2457011,2458657,1646,,740
MT2253,2459424,2458783,641,,740
MT2254,2460323,2459427,896,,740
MT2255,2460928,2460512,416,,740
MT2256,2462027,2460939,1088,,740
MT2257,2462273,2464228,1955,,740
MT2258,2465303,2464332,971,,740
MT2259,2465507,2466196,689,,740
MT2260,2466563,2466210,353,,740
MT2261,2467808,2466666,1142,,740
MT2262,2467898,2468605,707,,740
MT2263,2468687,2469769,1082,,737
MT2264,2469769,2470515,746,,737
MT2265,2470676,2472211,1535,,737
MT2266,2473246,2472143,1103,,737
MT2267,2474457,2473321,1136,,737
MT2268,2474436,2475599,1163,,737
MT2269,2475614,2477158,1544,,734
MT2270,2478977,2477202,1775,,734
MT2272,2479241,2480899,1658,,734
MT2273,2480899,2481804,905,,734
MT2274,2481830,2482549,719,,734
MT2275,2482549,2483481,932,,734
MT2276,2483511,2484260,749,,734
MT2277,2484764,2484273,491,,731
MT2278,2484889,2486322,1433,,731
MT2279,2489627,2486646,2981,,731
MT2280,2491016,2489679,1337,,731
MT2281,2492673,2491114,1559,,731
MT2282,2494258,2492738,1520,,731
MT2283,2494690,2494502,188,,731
MT2284,2495016,2495858,842,,731
MT2285,2496106,2497644,1538,,731
MT2285.2,2498197,2498421,224,,731
MT2286,2498421,2498903,482,,731
MT2287,2500012,2498921,1091,,728
MT2289,2501880,2500012,1868,,728
MT2290,2502854,2501880,974,,728
MT2291,2503427,2503011,416,,728
MT2292,2503550,2504422,872,,728
MT2293,2504418,2504906,488,,728
MT2294,2504909,2505721,812,,728
MT2295,2506647,2505709,938,,725
MT2296,2506713,2507525,812,,725
MT2297,2507859,2507626,233,,725
MT2298,2508448,2507990,458,,725
MT2299,2508924,2508451,473,,725
MT2300,2509747,2508965,782,,725
MT2301,2509811,2512513,2702,,725
MT2302,2512576,2513817,1241,,722
MT2303,2514059,2514964,905,,722
MT2304,2515043,2515387,344,,722
MT2305,2515387,2516634,1247,,722
MT2306,2516731,2517981,1250,,722
MT2307,2518015,2519433,1418,,722
MT2308,2519631,2520443,812,,722
MT2309,2522045,2520504,1541,,722
MT2310,2522704,2522048,656,,719
MT2311,2522662,2524248,1586,,719
MT2312,2524248,2525173,925,,719
MT2314,2525242,2525742,500,,719
MT2315,2526233,2525781,452,,719
MT2316,2526352,2526567,215,,719
MT2317,2527132,2526602,530,,719
MT2318,2528080,2527265,815,,719
MT2319,2529155,2528097,1058,,719
MT2320,2529450,2530532,1082,,719
MT2321,2530532,2531167,635,,719
MT2322,2532755,2531250,1505,,716
MT2323,2532844,2533794,950,,716
MT2324,2535553,2533778,1775,,716
MT2325,2535625,2535753,128,,716
MT2326,2535848,2535756,92,,716
MT2327,2535903,2537129,1226,,716
MT2328,2537307,2538590,1283,,713
MT2329,2540013,2538850,1163,,713
MT2330,2541479,2540013,1466,,713
MT2330.1,2541763,2541584,179,,713
MT2331,2541901,2542425,524,,713
MT2332,2542535,2542831,296,,713
MT2333,2542940,2543305,365,,713
MT2334,2543305,2543631,326,,710
MT2334.1,2544045,2543878,167,,710
MT2335,2544086,2544952,866,,710
MT2336,2544952,2546139,1187,,710
MT2337,2547241,2546330,911,,710
MT2338,2547405,2548781,1376,,710
MT2339,2549018,2550673,1655,,710
MT2340,2551721,2550786,935,,710
MT2341,2552018,2551773,245,,710
MT2342,2551990,2553282,1292,,710
MT2343,2553318,2554652,1334,,710
MT2344,2555414,2554725,689,,710
MT2345,2555548,2557173,1625,,707
MT2345.1,2557173,2557547,374,,707
MT2346,2557520,2558299,779,,707
MT2347,2558381,2558956,575,,707
MT2348,2559067,2559870,803,,707
MT2349,2560098,2559877,221,,707
MT2350,2560877,2560140,737,,707
MT2351,2561232,2562392,1160,,707
MT2352,2562692,2563252,560,,707
MT2353,2563349,2564248,899,,707
MT2354,2564283,2564732,449,,707
MT2355,2564927,2565895,968,,707
MT2356,2567847,2565907,1940,,704
MT2357,2568853,2567924,929,,704
MT2358,2568893,2569549,656,,704
MT2359,2569658,2569897,239,,704
MT2360,2570864,2569944,920,,704
MT2361,2571070,2570864,206,,704
MT2361.1,2571632,2571456,176,,701
MT2362,2571654,2572940,1286,,701
MT2363,2573665,2573042,623,,701
MT2364,2574541,2573699,842,,701
MT2364.1,2574738,2574845,107,,701
MT2365,2575264,2575076,188,,698
MT2365.1,2575750,2575352,398,,698
MT2365.2,2576055,2575876,179,,698
MT2366,2576264,2576977,713,,698
MT2367,2576990,2577319,329,,695
MT2367.1,2577595,2577272,323,,695
MT2368,2578143,2577691,452,,695
MT2369,2578285,2578163,122,,695
MT2370,2578489,2578325,164,,695
MT2370.1,2578675,2578523,152,,695
MT2370.2,2578836,2578675,161,,695
MT2370.3,2578890,2579174,284,,692
MT2371,2579122,2579271,149,,692
MT2372,2579280,2579621,341,,692
MT2373,2579729,2580250,521,,692
MT2374,2580331,2580597,266,,692
MT2375,2580698,2580585,113,,692
MT2376,2581751,2580900,851,,692
MT2377,2583135,2581765,1370,,692
MT2378,2584649,2583135,1514,,692
MT2379,2584683,2585552,869,,692
MT2380,2585542,2586363,821,,692
MT2381,2586363,2587640,1277,,692
MT2382,2588570,2587695,875,,692
MT2383,2589982,2588570,1412,,692
MT2384.1,2591208,2590001,1207,,689
MT2385,2592113,2591208,905,,689
MT2386,2592178,2592621,443,,689
MT2387,2593701,2592856,845,,689
MT2388,2595791,2593701,2090,,689
MT2389,2595832,2596320,488,,689
MT2390,2596470,2597720,1250,,689
MT2391,2599305,2597761,1544,,689
MT2392,2600066,2599542,524,,689
MT2393,2599940,2600524,584,,689
MT2394,2600952,2602595,1643,,689
MT2395,2604165,2602555,1610,,686
MT2396,2604192,2604359,167,,686
MT2397,2604640,2605569,929,,686
MT2398,2605576,2606262,686,,686
MT2399,2606681,2607646,965,,686
MT2400,2608831,2607716,1115,,686
MT2401,2609907,2608954,953,,686
MT2401.1,2610196,2609915,281,,686
MT2401.2,2610291,2610497,206,,686
MT2402,2610537,2613422,2885,,686
MT2404,2614752,2613514,1238,,683
MT2405,2615037,2614870,167,,683
MT2406,2615441,2615857,416,,683
MT2407,2616080,2616370,290,,683
MT2408,2618296,2616380,1916,,683
MT2409,2619596,2618304,1292,,683
MT2410,2619665,2621644,1979,,683
MT2411,2622016,2621735,281,,683
MT2412,2622363,2622070,293,,680
MT2413,2622824,2622501,323,,680
MT2414,2624542,2623019,1523,,680
MT2415,2626163,2624628,1535,,680
MT2416,2627943,2626384,1559,,680
MT2417,2628124,2628234,110,,680
MT2418,2628409,2628633,224,,680
MT2419,2629942,2628770,1172,,680
MT2420,2630434,2630147,287,,680
MT2421,2630742,2630446,296,,677
MT2422,2632078,2630834,1244,,677
MT2423,2634280,2632418,1862,,677
MT2423.1,2634798,2634433,365,,677
MT2424,2634821,2634928,107,,677
MT2425,2636865,2635021,1844,,677
MT2426,2638394,2637006,1388,,677
MT2427,2638576,2638980,404,,677
MT2428,2638980,2639369,389,,677
MT2429,2639908,2639483,425,,677
MT2430,2640798,2639911,887,,677
MT2431,2641588,2640794,794,,674
MT2432,2641650,2643101,1451,,674
MT2433,2644003,2643104,899,,674
MT2434,2644358,2644080,278,,674
MT2435,2645610,2644393,1217,,674
MT2436,2646227,2645697,530,,674
MT2437,2647304,2646249,1055,,674
MT2438,2647553,2647443,110,,674
MT2439,2648888,2647578,1310,,674
MT2440,2648981,2649265,284,,674
MT2441,2650155,2649370,785,,674
MT2442,2651317,2650172,1145,,671
MT2443,2652423,2651395,1028,,671
MT2444,2652595,2652909,314,,671
MT2445,2653445,2652942,503,,671
MT2445.1,2653760,2653548,212,,671
MT2446,2655033,2653741,1292,,671
MT2447,2659415,2655033,4382,,671
MT2448,2664760,2659400,5360,,671
MT2449,2667614,2664588,3026,,671
MT2450,2668939,2667602,1337,,671
MT2451,2673167,2668926,4241,,671
MT2452,2673266,2674960,1694,,671
MT2453,2674996,2675976,980,,671
MT2454,2677335,2675986,1349,,671
MT2455,2677788,2677994,206,,671
MT2456,2678056,2679345,1289,,671
MT2457,2680517,2679348,1169,,668
MT2458,2681042,2680581,461,,668
MT2459,2681596,2681042,554,,668
MT2460,2681817,2681915,98,,668
MT2461,2682033,2683697,1664,,668
MT2462,2683697,2684458,761,,668
MT2463,2684458,2685300,842,,668
MT2464,2685340,2687268,1928,,668
MT2465,2687402,2689402,2000,,665
MT2466,2689554,2689766,212,,665
MT2467,2689881,2690042,161,,665
MT2467.1,2690066,2691211,1145,,665
MT2468,2692300,2691242,1058,,665
MT2469,2693129,2692314,815,,665
MT2470,2693977,2693129,848,,665
MT2471,2695044,2693977,1067,,665
MT2472,2694983,2695384,401,,664
MT2473,2695566,2695375,191,,662
MT2474,2695859,2697784,1925,,662
MT2475,2698620,2697868,752,,662
MT2476,2700578,2698620,1958,,662
MT2477,2700717,2701163,446,,662
MT2478,2701630,2701340,290,,662
MT2479,2701693,2702364,671,,662
MT2480,2702607,2702338,269,,659
MT2481,2702581,2703582,1001,,659
MT2482,2704182,2703346,836,,659
MT2483,2705159,2704185,974,,659
MT2484,2706814,2705162,1652,,659
MT2485,2706924,2707181,257,,659
MT2486,2708168,2707203,965,,659
MT2487,2709734,2708184,1550,,659
MT2488,2710381,2709743,638,,659
MT2488.1,2710931,2710326,605,,659
MT2489,2712136,2710976,1160,,656
MT2490,2713163,2712324,839,,656
MT2491,2713987,2713247,740,,656
MT2492,2714648,2713980,668,,656
MT2493,2715025,2714648,377,,656
MT2494,2715657,2715025,632,,656
MT2495,2715932,2716201,269,,656
MT2496,2716446,2717489,1043,,656
MT2497,2718626,2717628,998,,653
MT2498,2720157,2718718,1439,,653
MT2499,2721032,2720160,872,,653
MT2500,2722326,2721082,1244,,653
MT2501,2722654,2722412,242,,653
MT2502,2722909,2722718,191,,653
MT2503,2723042,2723626,584,,653
MT2504,2723655,2724185,530,,653
MT2505,2724856,2724188,668,,653
MT2506,2725115,2724819,296,,653
MT2507,2725983,2725696,287,,653
MT2508,2727409,2725967,1442,,653
MT2509,2729598,2727409,2189,,653
MT2510,2729761,2729636,125,,653
MT2511,2730079,2730990,911,,653
MT2512,2731207,2731641,434,,650
MT2513,2733857,2731644,2213,,650
MT2514,2733837,2733962,125,,650
MT2515,2735096,2733969,1127,,650
MT2516,2736550,2735099,1451,,650
MT2517,2736881,2736624,257,,650
MT2518,2737210,2736899,311,,650
MT2518.1,2737604,2737380,224,,650
MT2519,2737555,2739027,1472,,650
MT2520,2740834,2738972,1862,,650
MT2520.1,2740962,2741414,452,,650
MT2521,2742570,2742163,407,,650
MT2522,2742984,2742616,368,,647
MT2523,2744444,2742984,1460,,647
MT2524,2747071,2744444,2627,,647
MT2525,2748466,2747162,1304,,647
MT2526,2749074,2748511,563,,647
MT2527,2749108,2749503,395,,644
MT2527.1,2749840,2749697,143,,644
MT2528,2750469,2749867,602,,644
MT2529,2751591,2750557,1034,,644
MT2530,2753564,2751591,1973,,644
MT2531,2755037,2753784,1253,,644
MT2532,2756333,2755056,1277,,644
MT2533,2756624,2757529,905,,641
MT2534,2757654,2759222,1568,,641
MT2535,2760020,2759379,641,,641
MT2536,2760619,2760020,599,,641
MT2537,2762136,2760739,1397,,641
MT2538,2762500,2763681,1181,,641
MT2539,2764510,2763707,803,,641
MT2540,2764995,2764519,476,,641
MT2541,2765004,2765879,875,,641
MT2542,2765831,2768413,2582,,641
MT2543,2768992,2768492,500,,640
MT2544,2769185,2768946,239,,638
MT2545,2769880,2769215,665,,638
MT2546,2770005,2770406,401,,638
MT2547,2770409,2772046,1637,,638
MT2547.1,2772123,2772407,284,,638
MT2547.2,2772501,2772355,146,,638
MT2548,2772452,2773126,674,,638
MT2549,2773814,2773164,650,,638
MT2550,2774236,2773823,413,,635
MT2551,2779107,2774236,4871,,635
MT2552,2780887,2779214,1673,,635
MT2553,2781474,2780971,503,,635
MT2554,2781442,2781591,149,,635
MT2554.1,2781749,2782003,254,,635
MT2554.2,2782084,2782401,317,,635
MT2555,2784770,2782404,2366,,635
MT2556,2786509,2784770,1739,,635
MT2557,2787981,2786509,1472,,632
MT2558,2788207,2788040,167,,632
MT2559,2789475,2788213,1262,,632
MT2560,2789837,2790604,767,,632
MT2561,2792872,2790791,2081,,632
MT2563,2796295,2792957,3338,,632
MT2563.1,2796695,2796336,359,,632
MT2564,2801738,2796744,4994,,632
MT2565,2802016,2801813,203,,629
MT2566,2802152,2802772,620,,629
MT2567,2802765,2803514,749,,629
MT2568,2803570,2803788,218,,629
MT2569,2803797,2804219,422,,629
MT2570,2805426,2804248,1178,,629
MT2571,2806469,2805426,1043,,629
MT2572,2807583,2806483,1100,,629
MT2573,2808663,2807845,818,,626
MT2574,2809217,2808663,554,,626
MT2575,2810398,2809217,1181,,626
MT2576,2812367,2810406,1961,,626
MT2577,2813961,2812375,1586,,626
MT2578,2814614,2813961,653,,626
MT2579,2815357,2814614,743,,626
MT2580,2817083,2815443,1640,,626
MT2581,2817151,2817843,692,,626
MT2582,2817919,2818743,824,,626
MT2583,2820089,2818746,1343,,623
MT2584,2820165,2820968,803,,623
MT2585,2822576,2820978,1598,,623
MT2586,2822644,2823288,644,,623
MT2586.1,2823338,2823736,398,,623
MT2587,2825353,2824046,1307,,623
MT2588,2825441,2825623,182,,623
MT2589,2825648,2826067,419,,623
MT2589.1,2826078,2826320,242,,623
MT2590,2826825,2826367,458,,620
MT2591,2828078,2826834,1244,,620
MT2593,2829000,2828200,800,,620
MT2593.1,2829290,2829000,290,,620
MT2593.2,2829429,2829193,236,,620
MT2594,2830822,2829599,1223,,620
MT2595,2831245,2832747,1502,,620
MT2596,2833102,2832878,224,,620
MT2597,2833171,2833641,470,,620
MT2598,2835028,2833619,1409,,620
MT2599,2835417,2835028,389,,620
MT2600,2844819,2835613,9206,,620
MT2600.1,2845063,2845305,242,,617
MT2601,2846061,2845342,719,,617
MT2601.1,2846062,2846394,332,,617
MT2601.2,2846577,2846801,224,,617
MT2602,2846801,2847199,398,,617
MT2603,2848157,2847240,917,,617
MT2604,2848361,2849749,1388,,617
MT2605,2850172,2849756,416,,617
MT2606,2850393,2850172,221,,614
MT2607,2853267,2850427,2840,,614
MT2608,2854211,2853342,869,,614
MT2609,2854777,2854217,560,,614
MT2610,2855905,2854790,1115,,611
MT2611,2855933,2856628,695,,611
MT2612,2857078,2856638,440,,611
MT2613,2858163,2857078,1085,,611
MT2614,2858690,2858163,527,,611
MT2615,2859899,2858697,1202,,611
MT2615.1,2859914,2861032,1118,,608
MT2616,2861032,2861826,794,,608
MT2617,2861968,2861744,224,,608
MT2618,2861956,2862612,656,,608
MT2619,2862612,2863268,656,,608
MT2620,2863268,2863927,659,,608
MT2621,2863927,2864202,275,,608
MT2622,2864295,2864708,413,,605
MT2623,2864735,2865004,269,,605
MT2624,2865004,2865378,374,,605
MT2625,2865771,2865400,371,,605
MT2626,2865724,2866278,554,,605
MT2627,2866508,2866266,242,,605
MT2627.1,2866835,2866629,206,,605
MT2628,2867338,2866922,416,,605
MT2629,2868159,2867353,806,,605
MT2630,2869409,2868159,1250,,605
MT2631,2869914,2869405,509,,605
MT2632,2872629,2869918,2711,,605
MT2633,2873109,2872723,386,,605
MT2634,2873216,2873887,671,,605
MT2635,2873975,2874682,707,,605
MT2636,2876073,2874718,1355,,602
MT2637,2876219,2877193,974,,602
MT2637.1,2877432,2877112,320,,602
MT2638,2877652,2878287,635,,602
MT2639,2878433,2879479,1046,,602
MT2640,2879485,2880474,989,,602
MT2641,2880754,2882502,1748,,602
MT2642,2882468,2885935,3467,,602
MT2643,2885938,2888589,2651,,602
MT2644,2889614,2888592,1022,,602
MT2645,2890551,2889610,941,,602
MT2646,2890655,2891041,386,,602
MT2647,2892103,2891039,1064,,602
MT2648,2893940,2892159,1781,,599
MT2649,2894099,2894923,824,,599
MT2650,2894949,2895449,500,,599
MT2651,2895482,2896360,878,,599
MT2652,2896833,2896372,461,,599
MT2653,2896809,2896952,143,,599
MT2654,2897061,2898647,1586,,599
MT2655,2899674,2898655,1019,,599
MT2656,2899782,2900681,899,,599
MT2657,2902235,2900967,1268,,596
MT2658,2902972,2902235,737,,596
MT2659,2902957,2903880,923,,596
MT2660,2906350,2903972,2378,,596
MT2661,2907043,2906375,668,,596
MT2662,2908820,2907150,1670,,596
MT2663,2910154,2908829,1325,,593
MT2664,2911822,2910161,1661,,593
MT2665,2912336,2911992,344,,593
MT2666,2912503,2913849,1346,,593
MT2667,2914014,2917517,3503,,593
MT2668,2917800,2917651,149,,590
MT2668.1,2917808,2919322,1514,,590
MT2669,2920376,2919345,1031,,590
MT2670,2920963,2920376,587,,590
MT2671,2921526,2920963,563,,590
MT2672,2921898,2922278,380,,590
MT2673,2922498,2923115,617,,590
MT2673.1,2923159,2923620,461,,590
MT2674,2923620,2924048,428,,590
MT2674.1,2924076,2924531,455,,590
MT2675,2924531,2926099,1568,,587
MT2676,2926213,2926497,284,,587
MT2677,2926487,2926924,437,,587
MT2678,2927703,2926951,752,,587
MT2679,2928432,2927839,593,,587
MT2680,2929285,2928443,842,,585
MT2681,2930234,2929317,917,,584
MT2682,2930341,2931012,671,,584
MT2683,2931189,2932928,1739,,584
MT2684,2934008,2932956,1052,,584
MT2685,2935144,2934011,1133,,584
MT2686,2936105,2935158,947,,584
MT2687,2936755,2936105,650,,584
MT2688,2937339,2936755,584,,584
MT2689,2939410,2937335,2075,,584
MT2689.1,2939519,2939743,224,,584
MT2690,2941173,2939746,1427,,584
MT2691.1,2941473,2941970,497,,581
MT2692,2942430,2941993,437,,581
MT2693,2942577,2943251,674,,581
MT2694,2943209,2943616,407,,581
MT2695,2944030,2943608,422,,581
MT2696,2944701,2944030,671,,581
MT2697,2944779,2945597,818,,581
MT2698,2945736,2946626,890,,581
MT2699,2947450,2946635,815,,578
MT2700,2948646,2947468,1178,,578
MT2701,2949136,2948708,428,,578
MT2702,2950891,2949653,1238,,578
MT2703,2951201,2951560,359,,578
MT2704,2951910,2953031,1121,,578
MT2705,2953036,2953572,536,,578
MT2707,2953715,2955010,1295,,578
MT2708,2955333,2955055,278,,575
MT2709,2955963,2955481,482,,575
MT2710,2956247,2955993,254,,575
MT2712,2958614,2956251,2363,,575
MT2713,2958613,2958852,239,,575
MT2714,2958856,2959530,674,,575
MT2715,2959729,2960382,653,,575
MT2716,2960548,2960991,443,,572
MT2717,2961501,2961172,329,,572
MT2718,2961980,2961624,356,,572
MT2719,2962082,2962537,455,,572
MT2720,2963053,2964546,1493,,572
MT2721,2964553,2964972,419,,569
MT2722,2965090,2965218,128,,569
MT2723,2966266,2966694,428,,569
MT2724,2966694,2967689,995,,569
MT2725,2967802,2968167,365,,566
MT2726,2968418,2968140,278,,566
MT2727,2970019,2968583,1436,,566
MT2728,2970560,2970030,530,,566
MT2729,2971204,2970716,488,,563
MT2730,2971694,2971374,320,,563
MT2731,2972019,2971777,242,,563
MT2732,2973443,2972019,1424,,563
MT2733,2973837,2973448,389,,563
MT2734,2974094,2973837,257,,563
MT2734.1,2974479,2974114,365,,563
MT2735,2975636,2974479,1157,,563
MT2736,2975975,2975751,224,,563
MT2736.1,2976116,2976271,155,,563
MT2737,2976638,2976868,230,,560
MT2738,2976882,2977133,251,,560
MT2739,2977484,2977762,278,,560
MT2740,2977793,2978656,863,,560
MT2741,2978681,2979436,755,,560
MT2742,2979414,2980037,623,,560
MT2743,2980069,2980536,467,,560
MT2744,2981626,2980520,1106,,560
MT2745,2981682,2982398,716,,560
MT2746,2982498,2984051,1553,,560
MT2747,2984077,2985375,1298,,560
MT2748,2985547,2985954,407,,560
MT2749,2986777,2986028,749,,560
MT2750,2987469,2986777,692,,557
MT2751,2988833,2987478,1355,,557
MT2752,2989948,2988833,1115,,557
MT2753,2989956,2990783,827,,557
MT2754,2991144,2991677,533,,557
MT2755,2991682,2992995,1313,,557
MT2756,2994911,2992998,1913,,554
MT2757,2995055,2995549,494,,554
MT2758,2995557,2996843,1286,,554
MT2759,2996926,2998209,1283,,554
MT2760,2998981,2998226,755,,554
MT2761,2999691,2998981,710,,554
MT2762,3000641,2999691,950,,554
MT2763,3002091,3000790,1301,,554
MT2764,3004151,3002181,1970,,554
MT2765,3004286,3004966,680,,554
MT2766,3004966,3005625,659,,551
MT2767,3006310,3005642,668,,551
MT2768,3006814,3006344,470,,551
MT2769,3006858,3007562,704,,551
MT2770,3008550,3007774,776,,551
MT2771,3009089,3008628,461,,551
MT2772,3009115,3009597,482,,551
MT2773,3009907,3009608,299,,548
MT2774,3010145,3010792,647,,548
MT2775,3011638,3010808,830,,548
MT2776,3011800,3012594,794,,548
MT2777,3012777,3014360,1583,,548
MT2777.1,3014400,3014825,425,,548
MT2778,3015139,3014759,380,,548
MT2779,3015265,3015450,185,,548
MT2780,3015515,3016486,971,,548
MT2781,3016738,3016493,245,,545
MT2782,3016781,3017224,443,,545
MT2783,3017403,3018371,968,,545
MT2784,3018501,3019190,689,,545
MT2785,3020264,3019209,1055,,545
MT2786,3020377,3021780,1403,,545
MT2787,3022001,3022972,971,,545
MT2788,3023034,3024056,1022,,545
MT2789,3024108,3024791,683,,545
MT2790,3025297,3024806,491,,545
MT2791,3025813,3025352,461,,545
MT2792,3026473,3025979,494,,542
MT2793,3026781,3027431,650,,542
MT2794,3029555,3027459,2096,,542
MT2794.1,3029535,3029816,281,,542
MT2795,3029845,3031035,1190,,542
MT2796,3032227,3031070,1157,,542
MT2797,3033848,3032181,1667,,542
MT2798,3034734,3033868,866,,542
MT2799,3035703,3034762,941,,542
MT2800,3036395,3035703,692,,542
MT2801,3037409,3036507,902,,539
MT2801.1,3037476,3037949,473,,539
MT2802,3037960,3039309,1349,,539
MT2802.1,3039851,3039312,539,,539
MT2803,3041459,3039924,1535,,539
MT2803.1,3041560,3041655,95,,539
MT2803.2,3041756,3042607,851,,536
MT2804,3043487,3042498,989,,536
MT2805,3044033,3043500,533,,536
MT2806,3046359,3043990,2369,,536
MT2807,3046808,3046458,350,,536
MT2808,3046947,3046744,203,,536
MT2808.1,3048220,3046961,1259,,533
MT2810,3048524,3048787,263,,533
MT2812,3048849,3050210,1361,,533
MT2813,3051097,3050240,857,,533
MT2814,3051954,3051145,809,,533
MT2815,3052785,3051976,809,,533
MT2816,3053253,3052918,335,,530
MT2817,3053953,3053327,626,,530
MT2818,3054014,3054505,491,,530
MT2819,3057483,3054580,2903,,530
MT2820,3057538,3058353,815,,530
MT2821,3058360,3059247,887,,530
MT2822,3060913,3059240,1673,,530
MT2823,3061846,3060947,899,,530
MT2824,3062667,3061918,749,,527
MT2825,3063186,3062914,272,,527
MT2826,3064805,3063186,1619,,527
MT2827,3065308,3064895,413,,527
MT2828,3065571,3065308,263,,527
MT2829,3065992,3065600,392,,527
MT2830,3066258,3065992,266,,527
MT2831,3067362,3066271,1091,,524
MT2832,3067778,3067362,416,,524
MT2833,3068331,3067855,476,,524
MT2834,3069202,3068405,797,,524
MT2835,3069358,3070092,734,,524
MT2836,3071092,3070313,779,,524
MT2837,3071615,3071328,287,,524
MT2838,3073004,3071619,1385,,524
MT2839,3073707,3072883,824,,524
MT2840,3075239,3074034,1205,,521
MT2841,3075755,3075306,449,,521
MT2842,3076314,3075844,470,,521
MT2843,3077063,3076329,734,,521
MT2844,3077487,3077077,410,,521
MT2845,3077535,3078089,554,,521
MT2846,3079187,3078099,1088,,521
MT2847,3080388,3079210,1178,,521
MT2848,3080905,3080438,467,,521
MT2849,3081482,3080940,542,,518
MT2850,3081542,3082654,1112,,518
MT2851,3083706,3082675,1031,,515
MT2852,3085083,3083770,1313,,515
MT2853,3087319,3085064,2255,,515
MT2854,3088188,3087676,512,,515
MT2855,3088470,3088204,266,,515
MT2856,3089621,3088629,992,,515
MT2857,3089823,3091592,1769,,512
MT2858,3091680,3092363,683,,512
MT2859,3093659,3092430,1229,,512
MT2860,3094887,3093688,1199,,512
MT2861,3096299,3094923,1376,,512
MT2862,3096880,3096302,578,,512
MT2862.1,3097978,3097085,893,,512
MT2863,3098658,3097978,680,,512
MT2864,3099629,3098658,971,,509
MT2865,3100340,3099777,563,,509
MT2866,3102025,3100340,1685,,509
MT2867,3102376,3102032,344,,509
MT2867.1,3102486,3103112,626,,509
MT2868,3103134,3104780,1646,,509
MT2869,3105238,3104888,350,,506
MT2870,3106571,3105501,1070,,506
MT2871,3106540,3107004,464,,506
MT2872,3107812,3107186,626,,506
MT2873,3107986,3108174,188,,506
MT2874,3108376,3109527,1151,,506
MT2875,3109752,3110018,266,,506
MT2876,3110126,3110434,308,,503
MT2877,3110626,3110462,164,,503
MT2878,3110928,3111461,533,,503
MT2879,3111535,3112941,1406,,503
MT2880,3112941,3113750,809,,503
MT2880.1,3114258,3114025,233,,503
MT2880.2,3114634,3114311,323,,503
MT2880.3,3115487,3114693,794,,503
MT2881,3116238,3115357,881,,500
MT2882,3116615,3116292,323,,500
MT2882.1,3117141,3116770,371,,500
MT2882.2,3117631,3117287,344,,500
MT2883,3118170,3117832,338,,500
MT2884,3119187,3118174,1013,,500
MT2885,3120492,3119203,1289,,500
MT2886,3121571,3120447,1124,,500
MT2887,3122476,3121571,905,,497
MT2888,3123167,3122460,707,,497
MT2889,3123551,3123180,371,,497
MT2890,3126001,3123551,2450,,497
MT2891,3126927,3125986,941,,497
MT2892,3127845,3127108,737,,497
MT2893,3128812,3127925,887,,497
MT2894,3129756,3128812,944,,494
MT2895,3129932,3129819,113,,494
MT2895.1,3130546,3130004,542,,494
MT2896,3131289,3130546,743,,494
MT2897,3131484,3132230,746,,494
MT2898,3133394,3132315,1079,,494
MT2899,3134439,3133390,1049,,494
MT2900,3135525,3134701,824,,494
MT2901,3136433,3135525,908,,494
MT2902,3137830,3136523,1307,,494
MT2903,3138796,3137849,947,,494
MT2904,3139382,3138834,548,,491
MT2905,3142084,3139385,2699,,491
MT2906,3142469,3142173,296,,491
MT2907,3143627,3142599,1028,,491
MT2908,3144187,3143639,548,,491
MT2909,3144382,3144924,542,,491
MT2910,3144924,3145409,485,,491
MT2911,3147149,3145416,1733,,491
MT2912,3148842,3147253,1589,,491
MT2913,3150082,3148868,1214,,491
MT2914,3151732,3150362,1370,,491
MT2915,3152355,3151735,620,,488
MT2916,3154208,3152379,1829,,488
MT2917,3154730,3154263,467,,488
MT2918,3156270,3154792,1478,,488
MT2919,3156333,3158321,1988,,488
MT2921,3158361,3159398,1037,,488
MT2922,3159414,3160790,1376,,488
MT2923,3160893,3162008,1115,,488
MT2924,3162558,3162031,527,,488
MT2925,3163568,3162795,773,,488
MT2926,3164932,3163568,1364,,488
MT2927,3165729,3164932,797,,488
MT2928,3167155,3165785,1370,,488
MT2929,3168172,3167318,854,,488
MT2930,3168798,3168217,581,,488
MT2931,3168956,3169147,191,,488
MT2932,3169147,3169524,377,,485
MT2933,3171465,3169612,1853,,485
MT2934,3172360,3171653,707,,485
MT2935,3173467,3172616,851,,485
MT2936,3174686,3173526,1160,,485
MT2937,3175917,3174706,1211,,485
MT2938,3177124,3175928,1196,,485
MT2939,3177536,3177976,440,,485
MT2940,3178059,3178718,659,,485
MT2941,3178817,3179005,188,,485
MT2942,3179001,3181085,2084,,482
MT2943,3181184,3181762,578,,482
MT2944,3182140,3181751,389,,482
MT2945,3183025,3182165,860,,482
MT2946,3183563,3183033,530,,482
MT2947,3184831,3183740,1091,,482
MT2948,3185903,3184857,1046,,482
MT2949,3186354,3185800,554,,482
MT2950,3186460,3186350,110,,482
MT2951,3187347,3186529,818,,482
MT2952,3187546,3188301,755,,482
MT2953,3189701,3188322,1379,,479
MT2954,3190585,3189701,884,,479
MT2955,3190584,3191000,416,,479
MT2956,3192438,3191020,1418,,479
MT2957,3193260,3192448,812,,479
MT2958,3194135,3193275,860,,479
MT2958.1,3194929,3194312,617,,479
MT2959,3196173,3194950,1223,,479
MT2960,3196330,3196190,140,,479
MT2961,3196573,3197547,974,,479
MT2962,3198494,3197550,944,,476
MT2963,3199499,3198537,962,,476
MT2964,3200587,3199421,1166,,476
MT2965,3202095,3200587,1508,,476
MT2966,3202520,3202098,422,,476
MT2967,3203559,3202732,827,,476
MT2968,3205898,3203562,2336,,476
MT2969,3206261,3205959,302,,476
MT2970,3207109,3206318,791,,476
MT2971,3208007,3207126,881,,476
MT2972,3208406,3208068,338,,476
MT2973,3208781,3209722,941,,476
MT2974,3210510,3209821,689,,476
MT2975,3211044,3210517,527,,476
MT2976,3211300,3211061,239,,473
MT2977,3211796,3211311,485,,473
MT2978,3212423,3211983,440,,473
MT2979,3212492,3213364,872,,473
MT2980,3214014,3213430,584,,473
MT2981,3215851,3214019,1832,,473
MT2982,3217731,3215923,1808,,473
MT2983,3217891,3218943,1052,,473
MT2984,3220437,3218863,1574,,473
MT2985,3220586,3222391,1805,,473
MT2986,3224831,3222408,2423,,470
MT2987,3225227,3224892,335,,470
MT2988,3226657,3225227,1430,,470
MT2988.1,3226759,3226667,92,,470
MT2989,3228459,3227194,1265,,470
MT2990,3232126,3228512,3614,,470
MT2991,3232419,3232141,278,,470
MT2992,3232819,3232409,410,,470
MT2993,3232811,3232954,143,,470
MT2994,3233790,3232924,866,,467
MT2995,3234871,3234152,719,,467
MT2996,3235455,3234871,584,,467
MT2997,3236285,3235545,740,,467
MT2998,3236512,3237300,788,,467
MT2998.1,3237290,3237598,308,,467
MT2999,3238017,3239765,1748,,467
MT3000,3239765,3245392,5627,,467
MT3002,3245392,3250005,4613,,467
MT3003,3250005,3256568,6563,,467
MT3004,3256568,3262048,5480,,467
MT3005,3262057,3266520,4463,,467
MT3006,3266534,3267526,992,,467
MT3007,3267526,3268392,866,,464
MT3008,3268392,3269219,827,,464
MT3009,3269269,3270534,1265,,464
MT3010,3277035,3270703,6332,,464
MT3011,3277655,3279394,1739,,461
MT3012,3279390,3282149,2759,,461
MT3013,3282321,3282109,212,,461
MT3014,3282516,3282349,167,,461
MT3015,3282784,3284022,1238,,461
MT3016,3284110,3284823,713,,461
MT3017,3285645,3284947,698,,461
MT3018,3290685,3285826,4859,,461
MT3021,3294274,3292160,2114,,461
MT3021.1,3292160,3290673,1487,,461
MT3022,3294929,3294294,635,,461
MT3023,3296664,3294919,1745,,461
MT3024,3296935,3297249,314,,458
MT3025,3298568,3297426,1142,,458
MT3026,3298761,3299570,809,,458
MT3027,3299599,3300852,1253,,458
MT3028,3301585,3300989,596,,458
MT3029,3302873,3301902,971,,455
MT3030,3302987,3303715,728,,455
MT3031,3303846,3304613,767,,455
MT3032,3304731,3304594,137,,455
MT3033,3304970,3304767,203,,455
MT3034,3306319,3305036,1283,,455
MT3035,3307157,3306423,734,,455
MT3036,3307622,3307275,347,,452
MT3037,3308048,3307638,410,,452
MT3038,3309441,3308095,1346,,452
MT3039,3309555,3310772,1217,,452
MT3041,3310848,3311777,929,,452
MT3041.1,3311786,3312301,515,,452
MT3042,3312363,3312602,239,,452
MT3043,3313134,3312652,482,,452
MT3044,3313786,3313223,563,,452
MT3045,3317365,3313985,3380,,452
MT3046,3318022,3317393,629,,452
MT3047,3318813,3318031,782,,452
MT3048,3319821,3318895,926,,452
MT3049,3320420,3321265,845,,452
MT3050,3322055,3321345,710,,449
MT3051,3324265,3322055,2210,,449
MT3052,3325680,3324271,1409,,449
MT3052.1,3325955,3325680,275,,449
MT3052.2,3326173,3326364,191,,449
MT3053,3327073,3326393,680,,449
MT3055,3328107,3327109,998,,449
MT3056,3329483,3328107,1376,,449
MT3057,3330067,3329486,581,,449
MT3058,3330179,3330820,641,,449
MT3058.1,3330823,3330996,173,,449
MT3058.2,3331000,3331173,173,,449
MT3059,3332294,3331176,1118,,449
MT3060,3333376,3332375,1001,,449
MT3061,3333495,3334136,641,,449
MT3062,3334234,3336456,2222,,446
MT3063,3336542,3337492,950,,446
MT3064,3338197,3337556,641,,446
MT3065,3339006,3338413,593,,446
MT3066,3340452,3339034,1418,,446
MT3067,3340422,3341222,800,,446
MT3068,3342096,3341239,857,,443
MT3069,3342359,3342847,488,,443
MT3070,3344654,3343185,1469,,443
MT3071,3345370,3344654,716,,443
MT3072,3345645,3346979,1334,,443
MT3073,3347844,3346837,1007,,440
MT3074,3349445,3347862,1583,,440
MT3075,3349475,3350914,1439,,440
MT3076,3351091,3351648,557,,440
MT3077,3351627,3351926,299,,440
MT3078,3351953,3352939,986,,440
MT3080,3352987,3353643,656,,440
MT3080.1,3353913,3353698,215,,440
MT3081,3354973,3353963,1010,,440
MT3082,3355505,3355002,503,,440
MT3083,3357361,3355508,1853,,440
MT3084,3358129,3357497,632,,440
MT3085,3358907,3358071,836,,440
MT3086,3359084,3360202,1118,,437
MT3087,3360921,3360214,707,,437
MT3088,3361019,3361639,620,,437
MT3089,3363168,3361642,1526,,437
MT3090,3364229,3363201,1028,,437
MT3091,3365809,3364328,1481,,437
MT3092,3366105,3365809,296,,437
MT3093,3366124,3366843,719,,437
MT3094,3368959,3366923,2036,,437
MT3095,3370039,3369029,1010,,434
MT3096,3370133,3370759,626,,434
MT3097,3371231,3370869,362,,434
MT3098,3371722,3371318,404,,434
MT3099,3371758,3372081,323,,434
MT3100,3372135,3373016,881,,434
MT3101,3373978,3373049,929,,434
MT3102,3374067,3373978,89,,434
MT3103,3374406,3374233,173,,434
MT3104,3374736,3374449,287,,434
MT3105,3375079,3374774,305,,431
MT3106,3376418,3375114,1304,,431
MT3106.1,3376828,3376418,410,,431
MT3107,3378358,3377114,1244,,431
MT3108,3379624,3378524,1100,,431
MT3109,3380802,3379624,1178,,431
MT3110,3381813,3380902,911,,431
MT3111,3382655,3381813,842,,431
MT3112,3383767,3382814,953,,431
MT3113,3384606,3383809,797,,431
MT3114,3384837,3385658,821,,431
MT3115,3385658,3387235,1577,,431
MT3116,3387270,3388511,1241,,428
MT3117,3388548,3388934,386,,428
MT3118,3389116,3389661,545,,428
MT3119,3390543,3389758,785,,428
MT3120,3391115,3392194,1079,,428
MT3121,3392877,3392197,680,,428
MT3122,3394026,3392953,1073,,428
MT3123,3395144,3394164,980,,428
MT3124,3395919,3395158,761,,428
MT3125,3396794,3395931,863,,428
MT3126,3397654,3396794,860,,428
MT3127,3398898,3397672,1226,,428
MT3128,3400657,3398939,1718,,425
MT3129,3400968,3401948,980,,425
MT3130,3402021,3403058,1037,,425
MT3131,3403424,3403053,371,,425
MT3131.1,3403398,3403553,155,,425
MT3132,3404042,3403761,281,,425
MT3133,3405114,3404143,971,,425
MT3134,3406819,3405248,1571,,425
MT3135,3406956,3406819,137,,425
MT3136,3407693,3406956,737,,425
MT3137,3409998,3407824,2174,,425
MT3138,3410420,3409971,449,,425
MT3139,3410694,3410458,236,,425
MT3139.1,3411076,3410675,401,,425
MT3140,3411741,3411160,581,,422
MT3141,3411587,3412414,827,,422
MT3142,3412427,3413464,1037,,422
MT3143,3414384,3413524,860,,422
MT3144,3415161,3414451,710,,422
MT3145,3415214,3416689,1475,,422
MT3145.1,3416763,3416638,125,,422
MT3146,3418995,3417466,1529,,422
MT3147,3421217,3419055,2162,,422
MT3148,3421374,3422894,1520,,422
MT3149,3423033,3425306,2273,,419
MT3149.1,3425358,3425537,179,,419
MT3150,3426040,3425618,422,,419
MT3150.1,3426177,3426497,320,,419
MT3151,3426497,3427102,605,,419
MT3152,3427218,3427625,407,,419
MT3153,3429412,3427772,1640,,419
MT3153.1,3429482,3429877,395,,419
MT3154,3429877,3430254,377,,416
MT3155,3430239,3431360,1121,,416
MT3156,3431503,3431408,95,,416
MT3157,3432103,3431591,512,,416
MT3158,3432475,3432122,353,,416
MT3159,3432569,3433840,1271,,416
MT3160,3434763,3433843,920,,416
MT3161,3434862,3435335,473,,416
MT3162,3435331,3437139,1808,,416
MT3163,3437143,3437541,398,,416
MT3164,3438387,3437563,824,,416
MT3165,3441778,3438449,3329,,416
MT3166,3441758,3443065,1307,,416
MT3167,3444252,3443197,1055,,416
MT3168,3444294,3445778,1484,,416
MT3169,3445787,3446710,923,,413
MT3170,3446710,3447537,827,,413
MT3171,3447571,3448674,1103,,413
MT3172,3448712,3450130,1418,,413
MT3173,3450130,3451551,1421,,413
MT3174,3451551,3453059,1508,,413
MT3174.1,3453256,3453152,104,,413
MT3174.2,3453861,3453562,299,,413
MT3175,3454001,3454885,884,,413
MT3176,3454906,3456594,1688,,413
MT3176.1,3457524,3456607,917,,410
MT3177,3458559,3457553,1006,,410
MT3178,3459743,3458559,1184,,410
MT3179,3459768,3460241,473,,410
MT3180,3460342,3461478,1136,,410
MT3181,3462886,3461576,1310,,410
MT3182,3463748,3463008,740,,410
MT3183,3465059,3464211,848,,410
MT3184,3465578,3465099,479,,410
MT3185,3466474,3465584,890,,410
MT3186,3467164,3466478,686,,410
MT3186.1,3467684,3467211,473,,410
MT3187,3468573,3467650,923,,410
MT3188,3469678,3468566,1112,,410
MT3189,3469803,3471170,1367,,407
MT3190,3472757,3471177,1580,,407
MT3191,3472787,3473293,506,,407
MT3192,3473418,3474521,1103,,407
MT3193,3474542,3474967,425,,407
MT3194,3474967,3475476,509,,407
MT3194.1,3475496,3475744,248,,407
MT3195,3475870,3476535,665,,407
MT3196,3476522,3477082,560,,407
MT3197,3477184,3478491,1307,,407
MT3198,3478572,3479738,1166,,407
MT3199,3479770,3480600,830,,407
MT3200,3480605,3480904,299,,407
MT3201,3480928,3481368,440,,404
MT3202,3481368,3481967,599,,404
MT3203,3482305,3483504,1199,,404
MT3204,3483822,3483592,230,,404
MT3205,3483885,3484352,467,,404
MT3206,3484380,3484856,476,,404
MT3207,3484965,3485102,137,,404
MT3208,3485236,3486168,932,,404
MT3209,3487447,3486275,1172,,404
MT3210,3487662,3487501,161,,404
MT3211,3487918,3487607,311,,404
MT3212,3487931,3488974,1043,,404
MT3214,3490238,3488967,1271,,401
MT3215,3490456,3490785,329,,401
MT3216,3492162,3490774,1388,,401
MT3217,3492311,3493342,1031,,401
MT3218,3495061,3493328,1733,,401
MT3219,3495711,3495061,650,,401
MT3220,3496545,3495742,803,,401
MT3220.1,3496979,3496707,272,,401
MT3220.2,3496971,3497213,242,,401
MT3221,3497278,3498417,1139,,401
MT3222,3498761,3498432,329,,401
MT3223,3498785,3498877,92,,401
MT3224,3498877,3499656,779,,398
MT3225,3499679,3500764,1085,,398
MT3226,3500847,3502250,1403,,398
MT3227,3502274,3503476,1202,,398
MT3228,3503579,3504547,968,,398
MT3229,3505129,3504605,524,,398
MT3230,3505138,3505536,398,,398
MT3231,3506801,3505575,1226,,398
MT3233,3507166,3507549,383,,398
MT3234,3507561,3508112,551,,398
MT3235,3508190,3508819,629,,398
MT3236,3508948,3510141,1193,,398
MT3237,3510141,3510896,755,,398
MT3238,3510896,3512230,1334,,398
MT3239,3512275,3514647,2372,,398
MT3240,3514766,3515995,1229,,398
MT3241,3515991,3516623,632,,398
MT3242,3516623,3517408,785,,395
MT3243,3517408,3517704,296,,395
MT3244,3517718,3519616,1898,,395
MT3245,3519613,3521274,1661,,395
MT3246,3521274,3522866,1592,,395
MT3247,3524686,3522878,1808,,395
MT3248,3526955,3524898,2057,,395
MT3249,3527648,3526974,674,,395
MT3250,3528771,3527626,1145,,392
MT3251,3529278,3528844,434,,392
MT3252,3530546,3529278,1268,,392
MT3253,3531538,3530579,959,,392
MT3254,3532028,3531549,479,,392
MT3255,3532990,3532028,962,,392
MT3256,3533753,3533067,686,,392
MT3257,3533735,3534868,1133,,392
MT3258,3534742,3535992,1250,,392
MT3259,3536120,3537481,1361,,392
MT3260,3538450,3537482,968,,392
MT3261,3538997,3538518,479,,389
MT3262,3539678,3539079,599,,389
MT3263,3539771,3540475,704,,389
MT3264,3540499,3541977,1478,,389
MT3265,3542996,3541980,1016,,389
MT3266,3543038,3543937,899,,389
MT3267,3543915,3544427,512,,389
MT3268,3544689,3544513,176,,386
MT3269,3544670,3544960,290,,386
MT3270,3545176,3546537,1361,,386
MT3270.1,3546597,3547007,410,,386
MT3271,3547321,3546890,431,,386
MT3272,3547776,3547327,449,,386
MT3273,3547744,3547875,131,,386
MT3274,3548067,3548348,281,,386
MT3275,3548348,3548674,326,,386
MT3275.1,3549095,3548937,158,,386
MT3276,3549215,3549559,344,,386
MT3277,3549559,3550176,617,,386
MT3278,3551604,3550342,1262,,386
MT3279,3551772,3551978,206,,386
MT3280,3552016,3552198,182,,386
MT3281,3553262,3552231,1031,,386
MT3282,3553757,3553590,167,,383
MT3283,3554464,3554925,461,,383
MT3284,3554947,3555111,164,,383
MT3285,3558076,3555101,2975,,383
MT3286,3559166,3558171,995,,383
MT3287,3559268,3560683,1415,,383
MT3288,3560692,3561588,896,,383
MT3289,3561800,3561603,197,,380
MT3290,3561928,3563268,1340,,380
MT3290.1,3563595,3563308,287,,380
MT3290.2,3563861,3563742,119,,380
MT3291,3566115,3564016,2099,,380
MT3292,3566239,3566490,251,,380
MT3293,3567666,3566509,1157,,380
MT3294,3568573,3567509,1064,,380
MT3295,3571940,3568638,3302,,380
MT3296,3575104,3571940,3164,,377
MT3297,3575181,3575396,215,,377
MT3298,3575430,3576212,782,,377
MT3299,3576218,3576520,302,,377
MT3300,3577408,3576533,875,,377
MT3301,3578613,3577438,1175,,377
MT3302,3579732,3578707,1025,,377
MT3303,3579907,3580590,683,,377
MT3304,3580873,3580583,290,,377
MT3305,3581174,3581734,560,,374
MT3306,3582442,3581750,692,,374
MT3307,3582701,3584281,1580,,374
MT3308,3584297,3585517,1220,,374
MT3309,3586396,3585599,797,,374
MT3310,3586475,3587158,683,,374
MT3311,3587158,3588273,1115,,374
MT3312,3588424,3588753,329,,371
MT3313,3588699,3589148,449,,371
MT3314,3589368,3590330,962,,371
MT3315,3590613,3590864,251,,371
MT3316,3592434,3590932,1502,,371
MT3317,3592690,3592454,236,,371
MT3318,3593256,3592954,302,,371
MT3319,3593804,3593256,548,,371
MT3320,3594655,3593804,851,,371
MT3321,3594751,3595596,845,,371
MT3322,3595922,3595698,224,,371
MT3323,3597340,3595919,1421,,371
MT3323.1,3598222,3597467,755,,371
MT3324,3598277,3599626,1349,,368
MT3325,3599626,3600615,989,,368
MT3326,3601934,3600654,1280,,368
MT3327,3603154,3602015,1139,,368
MT3328,3603773,3603267,506,,368
MT3329,3604657,3603773,884,,368
MT3330,3605283,3604684,599,,368
MT3331,3606089,3605277,812,,368
MT3332,3606200,3606838,638,,365
MT3333,3608016,3606862,1154,,365
MT3334,3608503,3608024,479,,365
MT3335,3609298,3608567,731,,365
MT3337,3612562,3609368,3194,,365
MT3338,3615430,3612584,2846,,365
MT3339,3616168,3615512,656,,365
MT3340,3617194,3616472,722,,365
MT3341,3618008,3617151,857,,365
MT3342,3619821,3618061,1760,,365
MT3343,3621512,3619812,1700,,365
MT3344,3622269,3621565,704,,365
MT3345,3622962,3622321,641,,365
MT3346,3624546,3623062,1484,,362
MT3347,3625343,3624654,689,,362
MT3348,3625465,3625286,179,,362
MT3349,3625640,3625473,167,,362
MT3350,3626887,3625640,1247,,359
MT3351,3628483,3626999,1484,,359
MT3352,3628538,3629959,1421,,359
MT3353,3631166,3629943,1223,,359
MT3354,3632214,3631177,1037,,359
MT3355,3633608,3632214,1394,,359
MT3356,3634201,3633713,488,,359
MT3357,3634216,3634740,524,,359
MT3358,3635142,3634774,368,,356
MT3359,3635442,3636434,992,,356
MT3361,3636434,3637777,1343,,356
MT3362,3637881,3638012,131,,356
MT3363,3638076,3639734,1658,,353
MT3364,3640876,3639800,1076,,353
MT3365,3641783,3640881,902,,353
MT3366,3642708,3641797,911,,353
MT3367,3642787,3644277,1490,,353
MT3368,3644319,3645005,686,,353
MT3369,3644977,3645411,434,,353
MT3370,3645425,3647578,2153,,353
MT3371,3648246,3647581,665,,353
MT3372,3648347,3649528,1181,,353
MT3373,3649536,3651827,2291,,353
MT3374,3652988,3651822,1166,,350
MT3375,3653537,3653016,521,,350
MT3376,3654823,3653537,1286,,350
MT3377,3654825,3655592,767,,350
MT3377.1,3655840,3655553,287,,350
MT3378,3656005,3656136,131,,350
MT3379,3656910,3656113,797,,347
MT3379.1,3656960,3658603,1643,,347
MT3380,3658629,3659054,425,,347
MT3381,3659054,3659719,665,,347
MT3382,3659763,3660653,890,,347
MT3383,3660653,3661081,428,,347
MT3384,3661192,3662991,1799,,347
MT3385,3663789,3663007,782,,344
MT3386,3664223,3663789,434,,344
MT3387,3664834,3664424,410,,344
MT3388,3665246,3664872,374,,344
MT3389,3666629,3665283,1346,,344
MT3390,3667132,3666683,449,,344
MT3391,3667163,3668407,1244,,344
MT3392,3668437,3669918,1481,,344
MT3393,3670830,3670024,806,,344
MT3394,3670901,3671563,662,,344
MT3395,3671610,3676148,4538,,344
MT3396,3676155,3676919,764,,344
MT3397,3677859,3676948,911,,341
MT3398,3680864,3677889,2975,,341
MT3399,3681735,3680821,914,,341
MT3400,3682412,3681750,662,,341
MT3401,3684277,3682523,1754,,341
MT3402,3685773,3684361,1412,,341
MT3403,3685873,3686508,635,,341
MT3404,3687699,3686533,1166,,341
MT3405,3688880,3687699,1181,,338
MT3406,3688945,3689748,803,,338
MT3407,3689755,3691356,1601,,338
MT3408,3691984,3691364,620,,338
MT3409,3692089,3692985,896,,338
MT3410,3692976,3694268,1292,,338
MT3411,3695224,3694295,929,,338
MT3412,3695414,3695247,167,,335
MT3413,3695937,3695596,341,,335
MT3414,3697071,3695978,1093,,335
MT3415,3698354,3697074,1280,,335
MT3416,3698752,3698354,398,,335
MT3417,3698989,3699324,335,,335
MT3418,3699324,3699755,431,,335
MT3419,3699887,3701656,1769,,335
MT3420,3701659,3702447,788,,332
MT3421,3702957,3702532,425,,332
MT3422,3703203,3702964,239,,332
MT3423,3703939,3703328,611,,332
MT3424,3704601,3703939,662,,332
MT3425,3705156,3704605,551,,332
MT3426,3705506,3705135,371,,329
MT3427,3706790,3705606,1184,,329
MT3427.1,3706934,3706821,113,,329
MT3428,3707312,3708454,1142,,329
MT3429,3709070,3708555,515,,329
MT3430,3709285,3711072,1787,,329
MT3431,3711856,3711011,845,,329
MT3432,3711922,3713319,1397,,329
MT3433,3713391,3714605,1214,,329
MT3434,3714704,3716203,1499,,329
MT3435,3716314,3717351,1037,,329
MT3436,3717479,3717375,104,,329
MT3437,3718341,3717547,794,,326
MT3437.1,3718366,3718842,476,,326
MT3438,3718864,3719301,437,,326
MT3439,3720207,3719341,866,,326
MT3440,3721238,3720231,1007,,326
MT3441,3721409,3722152,743,,323
MT3442,3723451,3722225,1226,,323
MT3443,3723734,3725080,1346,,323
MT3444,3725095,3726231,1136,,323
MT3445,3726252,3726959,707,,323
MT3447,3729258,3726974,2284,,323
MT3448,3730323,3729310,1013,,323
MT3449,3735004,3730484,4520,,323
MT3449.1,3735108,3734992,116,,323
MT3449.2,3735336,3735428,92,,323
MT3450,3735685,3735431,254,,323
MT3453,3745415,3735918,9497,,323
MT3454,3745944,3745456,488,,320
MT3455,3745996,3746484,488,,320
MT3456,3747264,3746527,737,,320
MT3456.1,3747946,3746819,1127,,320
MT3458,3759538,3748186,11352,,320
MT3459,3760363,3759572,791,,320
MT3460,3760816,3760448,368,,317
MT3461,3761303,3760962,341,,317
MT3462,3761334,3761720,386,,317
MT3463,3762030,3761740,290,,317
MT3464,3762860,3762030,830,,317
MT3465,3762996,3763268,272,,317
MT3466,3763268,3763522,254,,314
MT3467,3763567,3764754,1187,,314
MT3468,3764874,3765239,365,,314
MT3469,3765790,3765242,548,,314
MT3470,3766378,3765800,578,,314
MT3471,3766727,3766362,365,,314
MT3472,3767097,3766708,389,,314
MT3474,3769724,3767097,2627,,314
MT3475,3769960,3770421,461,,314
MT3476,3770680,3772563,1883,,311
MT3477,3773211,3772570,641,,311
MT3478,3773210,3773641,431,,311
MT3480,3777029,3773736,3293,,311
MT3481,3777164,3778501,1337,,311
MT3482,3778546,3779718,1172,,311
MT3483,3779718,3779876,158,,308
MT3484,3779958,3780845,887,,308
MT3485,3780853,3782277,1424,,308
MT3486,3782388,3783038,650,,308
MT3487,3784585,3783083,1502,,308
MT3488,3785480,3784593,887,,308
MT3489,3787325,3785492,1833,,308
MT3490,3788311,3787325,986,,308
MT3491,3789375,3788314,1061,,308
MT3491.1,3789809,3789934,125,,308
MT3492,3790512,3790120,392,,305
MT3493,3790817,3790512,305,,305
MT3494,3790966,3791667,701,,305
MT3494.1,3791660,3792334,674,,305
MT3495,3792395,3794719,2324,,305
MT3496,3795665,3794796,869,,305
MT3497,3795739,3796446,707,,305
MT3498,3796495,3798444,1949,,305
MT3499,3799311,3798451,860,,305
MT3500,3799335,3800258,923,,305
MT3501,3801794,3800319,1475,,302
MT3502,3802579,3801899,680,,302
MT3503,3802578,3803216,638,,302
MT3504,3804952,3803378,1574,,302
MT3505,3805872,3804967,905,,302
MT3506,3806980,3805904,1076,,302
MT3507,3807003,3808046,1043,,302
MT3508,3808113,3808898,785,,302
MT3509,3808916,3811273,2357,,302
MT3510,3812767,3811532,1235,,302
MT3510.1,3813093,3813001,92,,302
MT3511,3814739,3813141,1598,,299
MT3512,3815460,3814759,701,,299
MT3513,3816144,3815581,563,,299
MT3514,3816206,3817090,884,,299
MT3515,3817128,3817424,296,,299
MT3516,3817433,3817831,398,,299
MT3517,3819603,3817870,1733,,299
MT3518,3820786,3819662,1124,,299
MT3519,3822395,3820809,1586,,299
MT3520,3822613,3822506,107,,299
MT3521,3822602,3823009,407,,299
MT3522,3823921,3823025,896,,299
MT3523,3824588,3823917,671,,299
MT3524,3825397,3824573,824,,299
MT3525,3825768,3826073,305,,299
MT3526,3827767,3826151,1616,,299
MT3527,3828164,3827865,299,,296
MT3528,3829465,3828434,1031,,296
MT3529,3829938,3829465,473,,296
MT3530,3830561,3829938,623,,296
MT3531,3831073,3830570,503,,296
MT3532,3832296,3831073,1223,,296
MT3532.1,3832256,3832483,227,,296
MT3532.2,3832952,3832593,359,,296
MT3533,3833115,3833648,533,,296
MT3534,3834755,3833595,1160,,296
MT3535,3834949,3834797,152,,296
MT3536,3835081,3834977,104,,296
MT3537,3836088,3835246,842,,296
MT3538,3837703,3836324,1379,,296
MT3539,3839162,3837744,1418,,296
MT3540,3839877,3839167,710,,296
MT3541,3840826,3839891,935,,296
MT3542,3842838,3840967,1871,,293
MT3542.1,3842860,3843333,473,,293
MT3543,3843346,3844185,839,,293
MT3544,3845611,3844211,1400,,293
MT3545,3845925,3845617,308,,293
MT3546,3847319,3845976,1343,,293
MT3547,3847899,3847447,452,,293
MT3548,3848339,3847899,440,,293
MT3549,3848874,3848575,299,,293
MT3550,3849302,3848898,404,,293
MT3551,3850479,3849268,1211,,290
MT3553,3854078,3850479,3599,,290
MT3554,3854300,3855700,1400,,290
MT3555,3855700,3857064,1364,,290
MT3556,3858480,3857035,1445,,290
MT3557,3858610,3859350,740,,290
MT3559,3859385,3860077,692,,290
MT3560,3860138,3860374,236,,290
MT3561,3860349,3862034,1685,,290
MT3562,3862892,3862002,890,,290
MT3563,3863379,3862840,539,,290
MT3564,3864454,3863414,1040,,287
MT3565,3865211,3864609,602,,287
MT3566,3865639,3865223,416,,287
MT3567,3866017,3865646,371,,287
MT3567.1,3866346,3866236,110,,287
MT3568,3866600,3866382,218,,287
MT3569,3866854,3867708,854,,287
MT3570,3867784,3868776,992,,287
MT3571,3868781,3869386,605,,287
MT3572,3869472,3870137,665,,287
MT3572.1,3870145,3871143,998,,284
MT3573,3870821,3872209,1388,,284
MT3573.01,3872203,3872997,794,,284
MT3573.10,3877457,3877561,104,,284
MT3573.11,3877513,3878184,671,,284
MT3573.12,3878235,3878657,422,,284
MT3573.13,3878857,3878696,161,,284
MT3573.14,3879383,3879066,317,,284
MT3573.15,3879990,3879583,407,,284
MT3573.16,3880146,3880021,125,,281
MT3573.02,3872997,3873392,395,,281
MT3573.03,3873392,3874807,1415,,281
MT3573.04,3874928,3875398,470,,281
MT3573.05,3875415,3875684,269,,281
MT3573.06,3875684,3875995,311,,281
MT3573.07,3876079,3876546,467,,281
MT3573.08,3876723,3877232,509,,281
MT3573.09,3877243,3877446,203,,281
MT3574,3881259,3880168,1091,,281
MT3575,3882267,3881266,1001,,281
MT3576,3883962,3882337,1625,,281
MT3577,3884552,3884001,551,,281
MT3578,3884552,3885055,503,,281
MT3579,3886022,3885141,881,,281
MT3580,3887552,3886206,1346,,278
MT3580.1,3887551,3887649,98,,278
MT3580.2,3887790,3887909,119,,278
MT3581,3887925,3888218,293,,278
MT3582,3888258,3889436,1178,,278
MT3583,3889490,3892714,3224,,278
MT3584,3894258,3892744,1514,,278
MT3585,3895014,3894328,686,,278
MT3586,3895938,3895159,779,,278
MT3587,3896644,3895985,659,,278
MT3588,3896907,3898445,1538,,275
MT3589,3899335,3898457,878,,275
MT3590,3899562,3900050,488,,275
MT3591,3900989,3900009,980,,275
MT3592,3901499,3901819,320,,275
MT3593,3901904,3902065,161,,275
MT3594,3902134,3903567,1433,,275
MT3595,3903721,3904296,575,,272
MT3596,3904778,3904299,479,,272
MT3597,3905506,3904781,725,,272
MT3598,3907200,3905509,1691,,272
MT3599,3908365,3907214,1151,,272
MT3600,3909714,3908365,1349,,272
MT3601,3910787,3909717,1070,,269
MT3602,3911829,3910780,1049,,269
MT3603,3913031,3911832,1199,,269
MT3604,3913893,3913054,839,,269
MT3605,3914641,3913931,710,,269
MT3606,3915872,3914862,1010,,269
MT3607,3916088,3915900,188,,269
MT3608,3916303,3917502,1199,,269
MT3609,3917530,3918648,1118,,269
MT3610,3918722,3920227,1505,,269
MT3612,3920401,3924552,4151,,269
MT3612.1,3924807,3929951,5144,,266
MT3613,3931669,3930124,1545,,266
MT3614,3932502,3931669,833,,266
MT3615.1,3932862,3938558,5696,,266
MT3615.2,3939346,3938693,653,,266
MT3615.3,3939392,3943042,3650,,266
MT3615.4,3943609,3943394,215,,266
MT3616,3945252,3943609,1643,,266
MT3617,3945326,3946114,788,,266
MT3618,3946411,3947049,638,,266
MT3619,3948225,3947110,1115,,266
MT3620,3948215,3948433,218,,266
MT3621,3949498,3948470,1028,,263
MT3622,3949570,3950571,1001,,263
MT3622.1,3950590,3951651,1061,,263
MT3623,3951671,3952852,1181,,263
MT3624,3952897,3953925,1028,,263
MT3625,3954466,3953945,521,,263
MT3626,3955738,3954557,1181,,263
MT3627,3955747,3956193,446,,263
MT3628,3956310,3956435,125,,260
MT3629,3957334,3956624,710,,260
MT3630,3957565,3957759,194,,260
MT3631,3957767,3957961,194,,260
MT3632,3959180,3958029,1151,,260
MT3633,3959962,3959183,779,,260
MT3634,3961086,3959962,1124,,257
MT3636,3961485,3962702,1217,,257
MT3637,3964595,3962850,1745,,257
MT3638,3965725,3964697,1028,,257
MT3639,3966642,3965734,908,,257
MT3640,3967438,3966656,782,,257
MT3641,3967502,3969199,1697,,257
MT3642,3969204,3970061,857,,254
MT3643,3970201,3971637,1436,,254
MT3644,3972801,3971644,1157,,254
MT3645,3973190,3972804,386,,254
MT3646,3974122,3973190,932,,254
MT3647,3975282,3974122,1160,,254
MT3648,3976304,3975270,1034,,254
MT3649,3977587,3976289,1298,,254
MT3650,3977699,3978871,1172,,254
MT3651,3978986,3979438,452,,254
MT3652,3980474,3979527,947,,251
MT3653,3981240,3980464,776,,251
MT3653.1,3981341,3981240,101,,251
MT3654,3981295,3982035,740,,251
MT3655,3982038,3982913,875,,251
MT3656,3982913,3983662,749,,251
MT3657,3983748,3984827,1079,,251
MT3658,3984866,3986881,2015,,251
MT3659,3987840,3986975,865,,248
MT3660,3989105,3987948,1157,,248
MT3661,3989772,3989173,599,,248
MT3663,3990121,3991989,1868,,248
MT3664,3992575,3991790,785,,248
MT3665,3993729,3992575,1154,,248
MT3666,3993798,3995297,1499,,248
MT3667,3995301,3996431,1130,,245
MT3668,3996437,3997387,950,,245
MT3669,3997387,3998340,953,,245
MT3670,3998340,3999502,1162,,245
MT3671,4000321,3999473,848,,245
MT3671.1,4000572,4000309,263,,245
MT3671.2,4000773,4000606,167,,245
MT3672,4001421,4000861,560,,245
MT3673,4002338,4001439,899,,245
MT3674,4003210,4002338,872,,245
MT3675,4004409,4003228,1181,,242
MT3676,4004556,4005629,1073,,242
MT3677,4005650,4006177,527,,242
MT3678,4008351,4006219,2132,,242
MT3679,4008491,4009219,728,,242
MT3680,4010442,4009231,1211,,242
MT3681,4010497,4011207,710,,242
MT3682,4011128,4012264,1136,,242
MT3684,4012281,4013519,1238,,242
MT3685,4014325,4013567,758,,242
MT3686,4015942,4014536,1406,,242
MT3687,4016486,4016010,476,,239
MT3688,4017178,4016486,692,,239
MT3689,4017683,4017198,485,,239
MT3690,4017801,4018514,713,,239
MT3691,4018583,4020022,1439,,239
MT3692,4020030,4021103,1073,,239
MT3693,4021925,4021110,815,,239
MT3694,4022633,4022013,620,,239
MT3695,4022632,4023543,911,,239
MT3696,4025297,4023546,1751,,239
MT3697,4026181,4025411,770,,239
MT3698,4026196,4026510,314,,239
MT3699,4026533,4027846,1313,,239
MT3700,4027996,4028820,824,,239
MT3701,4030180,4028873,1307,,236
MT3703,4032834,4030291,2543,,236
MT3704,4033449,4033114,335,,236
MT3705,4035070,4033556,1514,,236
MT3706,4035989,4035174,815,,236
MT3706.1,4036411,4035995,416,,236
MT3707,4037340,4036414,926,,233
MT3708,4038422,4037340,1082,,233
MT3709,4039625,4038435,1190,,233
MT3710,4040310,4039837,473,,233
MT3711,4040876,4040313,563,,233
MT3712,4042085,4041270,815,,233
MT3712.1,4041274,4040876,398,,233
MT3713,4042714,4042109,605,,233
MT3714,4045012,4042733,2279,,233
MT3715,4046087,4045761,326,,233
MT3716,4046936,4046385,551,,230
MT3717,4047363,4047055,308,,230
MT3718,4048615,4047440,1175,,230
MT3718.1,4048704,4048913,209,,230
MT3718.2,4049728,4049886,158,,230
MT3719,4049973,4050938,965,,230
MT3720,4050938,4052122,1184,,230
MT3721,4052508,4052227,281,,230
MT3722,4052831,4052538,293,,230
MT3723,4054129,4052891,1238,,230
MT3724,4054438,4054142,296,,230
MT3725,4054767,4055486,719,,227
MT3726,4056102,4055497,605,,227
MT3727,4057112,4056144,968,,227
MT3728,4058164,4057094,1070,,227
MT3729,4059525,4058143,1382,,227
MT3730,4059663,4060148,485,,227
MT3731,4061321,4060200,1121,,224
MT3732,4061415,4062707,1292,,224
MT3733,4062766,4063476,710,,224
MT3734,4063476,4063817,341,,224
MT3735,4064031,4064903,872,,224
MT3736,4065875,4064910,965,,224
MT3737,4065874,4067646,1772,,224
MT3739,4067992,4069221,1229,,224
MT3740,4069224,4069967,743,,224
MT3741,4070690,4070127,563,,224
MT3742,4071989,4070763,1226,,224
MT3743,4072800,4072168,632,,224
MT3743.1,4073005,4072814,191,,224
MT3744,4073170,4073301,131,,224
MT3745,4073465,4073304,161,,224
MT3746,4073491,4073589,98,,224
MT3747,4074971,4073760,1211,,221
MT3748,4075048,4076694,1646,,221
MT3749,4079498,4076697,2801,,221
MT3750,4080429,4079854,575,,221
MT3750.1,4080772,4080572,200,,221
MT3751,4081022,4083334,2312,,221
MT3752,4083474,4083755,281,,218
MT3753,4084082,4085116,1034,,218
MT3754,4085492,4085265,227,,218
MT3755,4085879,4085637,242,,218
MT3756,4086040,4086783,743,,218
MT3756.1,4087227,4086922,305,,215
MT3756.2,4087558,4087262,296,,215
MT3756.3,4087710,4087585,125,,215
MT3757,4087688,4088602,914,,215
MT3758,4089196,4088399,797,,215
MT3759,4090251,4089196,1055,,215
MT3760,4091138,4090356,782,,215
MT3761,4091904,4092764,860,,215
MT3762,4093253,4093125,128,,212
MT3763,4094292,4093525,767,,212
MT3764,4095935,4094292,1643,,212
MT3765,4096732,4095935,797,,212
MT3766,4097714,4096791,923,,212
MT3767,4099341,4097719,1622,,212
MT3767.1,4099427,4099780,353,,212
MT3767.2,4099717,4099923,206,,212
MT3767.3,4099916,4100035,119,,209
MT3768,4100049,4102001,1952,,209
MT3769,4102738,4102043,695,,209
MT3770,4103530,4102823,707,,209
MT3771,4103603,4104583,980,,209
MT3772,4105772,4104582,1190,,209
MT3773,4106599,4105781,818,,209
MT3774,4107414,4106734,680,,209
MT3775,4108202,4107417,785,,209
MT3776,4108259,4108633,374,,209
MT3777,4108735,4109406,671,,209
MT3778,4110307,4109516,791,,209
MT3779,4110769,4110317,452,,209
MT3780,4110946,4110788,158,,206
MT3781,4111031,4112050,1019,,206
MT3782,4112050,4113207,1157,,206
MT3783,4113809,4113456,353,,206
MT3784,4114171,4116600,2429,,206
MT3785,4116672,4117628,956,,206
MT3786,4117628,4118731,1103,,206
MT3787,4120980,4119553,1427,,203
MT3788,4121506,4121009,497,,203
MT3789,4121946,4121581,365,,203
MT3790,4122612,4122151,461,,203
MT3791,4122612,4123964,1352,,203
MT3792,4123946,4124644,698,,203
MT3793,4124629,4125771,1142,,200
MT3794,4125771,4126844,1073,,200
MT3795,4126875,4128299,1424,,200
MT3796,4129563,4128379,1184,,200
MT3797,4129583,4130389,806,,197
MT3798,4132009,4130459,1550,,197
MT3799,4132496,4132062,434,,197
MT3800,4132717,4132496,221,,194
MT3801,4132747,4134273,1526,,194
MT3802,4134289,4134996,707,,194
MT3803,4136189,4135005,1184,,194
MT3804,4137170,4136208,962,,194
MT3805,4137751,4137170,581,,191
MT3806,4139145,4137871,1274,,191
MT3807,4140440,4139145,1295,,191
MT3808,4141216,4140575,641,,191
MT3808.1,4141734,4141348,386,,191
MT3809,4142165,4141848,317,,191
MT3810,4143294,4142287,1007,,191
MT3811,4144471,4143437,1034,,191
MT3812,4145737,4144475,1262,,191
MT3813,4145949,4147925,1976,,188
MT3814,4148983,4147997,986,,188
MT3814.1,4149249,4148983,266,,188
MT3815,4149294,4150532,1238,,188
MT3816,4150540,4151232,692,,188
MT3817,4152269,4151247,1022,,188
MT3818,4152813,4152205,608,,188
MT3819,4153226,4152828,398,,188
MT3820,4153361,4154083,722,,188
MT3821,4154571,4154131,440,,188
MT3822,4154631,4156028,1397,,185
MT3823,4156028,4157308,1280,,185
MT3824,4159044,4157311,1733,,185
MT3825,4160441,4159137,1304,,185
MT3826,4160848,4161609,761,,185
MT3827,4161858,4162478,620,,182
MT3828,4162526,4163452,926,,182
MT3829,4163733,4164923,1190,,182
MT3830,4165267,4167072,1805,,182
MT3831,4167167,4170379,3212,,182
MT3833,4170597,4172924,2327,,179
MT3835,4174032,4172995,1037,,179
MT3836,4174070,4175143,1073,,179
MT3837,4175246,4176301,1055,,179
MT3838,4176824,4176327,497,,179
MT3839,4178202,4176841,1361,,179
MT3840,4178392,4178886,494,,179
MT3841,4178946,4180004,1058,,179
MT3842,4180011,4181597,1586,,176
MT3844,4182829,4181600,1229,,176
MT3846,4182942,4182829,113,,176
MT3847,4183140,4183033,107,,176
MT3848,4184491,4183148,1343,,173
MT3849,4185165,4184494,671,,173
MT3850,4185557,4185165,392,,173
MT3851,4187685,4185706,1979,,173
MT3852,4187707,4188111,404,,173
MT3853,4188410,4188201,209,,170
MT3854,4188854,4188486,368,,170
MT3855,4189808,4188867,941,,167
MT3856,4190450,4189944,506,,167
MT3857,4190910,4190521,389,,167
MT3858,4191370,4191071,299,,167
MT3859,4192017,4191562,455,,167
MT3860,4192533,4192036,497,,167
MT3861,4192667,4193635,968,,167
MT3862,4194200,4193604,596,,167
MT3863,4194925,4194209,716,,167
MT3864,4195611,4194925,686,,167
MT3865,4196702,4195602,1100,,167
MT3866,4197769,4196741,1028,,164
MT3867,4197799,4198149,350,,164
MT3868,4199229,4198177,1052,,164
MT3869,4201212,4199311,1901,,164
MT3870,4201359,4201835,476,,164
MT3871,4203414,4201897,1517,,164
MT3872,4204252,4203395,857,,164
MT3873,4204605,4205291,686,,164
MT3874,4206252,4205311,941,,164
MT3875,4206382,4206738,356,,161
MT3876,4207304,4206789,515,,161
MT3876.1,4207394,4207522,128,,161
MT3877,4208087,4207515,572,,161
MT3878,4208375,4208196,179,,161
MT3879,4208581,4208393,188,,161
MT3880,4209042,4208719,323,,161
MT3881,4209446,4210504,1058,,161
MT3882,4211137,4210556,581,,158
MT3883,4211161,4211982,821,,158
MT3884,4211997,4213241,1244,,158
MT3885,4213332,4214957,1625,,158
MT3886,4215006,4215989,983,,158
MT3887,4217207,4216014,1193,,158
MT3888,4217297,4219294,1997,,158
MT3889,4219313,4219834,521,,158
MT3890,4219841,4220659,818,,155
MT3891,4220659,4221570,911,,155
MT3892,4221570,4222409,839,,155
MT3893,4222568,4224703,2135,,152
MT3894,4225910,4224690,1220,,152
MT3895,4226849,4225926,923,,152
MT3896,4227093,4227575,482,,152
MT3897,4227624,4228049,425,,152
MT3898,4228086,4229474,1388,,152
MT3899,4229478,4230239,761,,152
MT3899.1,4230245,4232515,2270,,152
MT3900,4232175,4235456,3281,,149
MT3901,4235545,4238826,3281,,149
MT3902,4238826,4242119,3293,,149
MT3903,4242301,4243314,1013,,149
MT3904,4243397,4245175,1778,,149
MT3905,4245315,4246646,1331,,149
MT3906,4248270,4246705,1565,,149
MT3907,4253468,4248270,5198,,149
MT3908,4255364,4253478,1886,,149
MT3909,4256687,4255680,1007,,149
MT3910,4257817,4256888,929,,149
MT3911,4259031,4257967,1064,,149
MT3912,4261200,4259278,1922,,149
MT3913,4262155,4261250,905,,146
MT3914,4262659,4262165,494,,146
MT3915,4264601,4262691,1910,,146
MT3916,4265797,4264601,1196,,146
MT3917,4266061,4266912,851,,146
MT3918,4267120,4268736,1616,,146
MT3919,4268909,4268766,143,,146
MT3920,4268893,4270404,1511,,146
MT3921,4270556,4270407,149,,146
MT3922,4271537,4270719,818,,143
MT3923,4272337,4271555,782,,143
MT3924,4273110,4272358,752,,143
MT3925,4273893,4273117,776,,143
MT3925.1,4273969,4274721,752,,143
MT3926,4274771,4276318,1547,,143
MT3927,4276321,4276650,329,,143
MT3928,4278147,4276744,1403,,143
MT3929,4278295,4279005,710,,143
MT3930,4279043,4280254,1211,,143
MT3931,4283851,4280585,3266,,140
MT3932,4285496,4283964,1532,,140
MT3933,4291927,4285550,6377,,140
MT3934,4292134,4293885,1751,,140
MT3935,4295111,4293888,1223,,137
MT3936,4295719,4295111,608,,137
MT3937,4297330,4295723,1607,,137
MT3938,4298007,4297381,626,,137
MT3939,4298079,4298558,479,,137
MT3940,4299145,4298561,584,,137
MT3941,4299189,4299977,788,,137
MT3942,4301236,4299980,1256,,137
MT3943,4301369,4302715,1346,,137
MT3944,4302735,4303133,398,,137
MT3945,4304029,4303334,695,,134
MT3946,4304991,4304029,962,,134
MT3947,4305087,4305860,773,,134
MT3948,4305940,4306299,359,,134
MT3949,4306500,4307042,542,,134
MT3950,4307890,4307063,827,,134
MT3951,4308918,4307893,1025,,131
MT3952,4309146,4309247,101,,131
MT3953,4309457,4309603,146,,131
MT3954,4310219,4310010,209,,131
MT3954.1,4311171,4310572,599,,131
MT3955,4311097,4311585,488,,128
MT3957,4312167,4311628,539,,128
MT3958,4312148,4312360,212,,128
MT3959,4312756,4312580,176,,128
MT3960,4313027,4313647,620,,128
MT3961,4313861,4314391,530,,128
MT3962,4314384,4314485,101,,128
MT3963,4314649,4315554,905,,125
MT3964,4315822,4316217,395,,125
MT3965,4316338,4316991,653,,125
MT3966,4317006,4317287,281,,125
MT3967,4317397,4317798,401,,125
MT3968,4317818,4318288,470,,125
MT3969,4319796,4318330,1466,,125
MT3970,4319872,4320519,647,,125
MT3971,4321731,4320727,1004,,125
MT3972,4321937,4321743,194,,122
MT3972.1,4322208,4322071,137,,122
MT3973,4323828,4322365,1463,,122
MT3974,4328410,4323824,4586,,119
MT3974.1,4328802,4328422,380,,119
MT3975,4329100,4330269,1169,,119
MT3976,4330844,4330497,347,,119
MT3977,4331171,4332346,1175,,119
MT3978,4332592,4333797,1205,,119
MT3979,4333888,4334196,308,,119
MT3980,4334196,4335640,1444,,119
MT3981,4335636,4337354,1718,,119
MT3982,4337361,4338800,1439,,116
MT3983,4338803,4341043,2240,,116
MT3984,4341043,4341156,113,,116
MT3985,4341149,4342921,1772,,116
MT3986,4343025,4343360,335,,116
MT3987,4343388,4344500,1112,,116
MT3988,4344596,4344895,299,,116
MT3989,4344931,4345215,284,,113
MT3990,4345332,4347329,1997,,113
MT3991,4347425,4348861,1436,,113
MT3992,4349014,4349853,839,,113
MT3993,4352085,4349917,2168,,113
MT3994,4352254,4352129,125,,113
MT3995,4352843,4352505,338,,113
MT3996,4354228,4352849,1379,,113
MT3997,4355723,4354338,1385,,113
MT3998,4356955,4355723,1232,,110
MT3999,4359156,4357285,1871,,110
MT4000,4360479,4359214,1265,,110
MT4001,4362345,4360823,1522,,110
MT4002,4363865,4362459,1406,,110
MT4003,4365007,4363985,1022,,107
MT4004,4365931,4365104,827,,107
MT4005,4366314,4366030,284,,107
MT4006,4366673,4366353,320,,107
MT4007,4367984,4366788,1196,,107
MT4008,4368296,4368066,230,,107
MT4010,4372753,4368566,4187,,104
MT4011,4374241,4372757,1484,,104
MT4012,4375152,4374247,905,,104
MT4013,4375946,4375305,641,,104
MT4014,4376291,4375962,329,,104
MT4016,4377685,4376456,1229,,104
MT4017,4378614,4377682,932,,104
MT4018,4379120,4378674,446,,104
MT4019,4379108,4379290,182,,104
MT4020,4380201,4379674,527,,104
MT4022,4382738,4380201,2537,,101
MT4023,4383015,4382746,269,,101
MT4024,4383337,4383029,308,,101
MT4025,4383912,4383406,506,,101
MT4026,4385379,4383940,1439,,98
MT4026.1,4385394,4385603,209,,98
MT4027,4385755,4386498,743,,98
MT4028,4386449,4388902,2453,,98
MT4029,4388902,4392453,3551,,98
MT4030,4392491,4393078,587,,95
MT4031,4393174,4393935,761,,95
MT4032,4394032,4395036,1004,,95
MT4033,4395036,4395383,347,,95
MT4034,4395496,4396713,1217,,95
MT4035,4397471,4396740,731,,95
MT4035.1,4397798,4397514,284,,95
MT4036,4398795,4397764,1031,,92
MT4037,4399937,4398795,1142,,92
MT4038,4400506,4399835,671,,92
MT4039,4401201,4400641,560,,92
MT4040,4402373,4401276,1097,,92
MT4040.1,4402719,4402360,359,,92
MT4041,4403066,4402719,347,,92
MT4041.1,4403233,4403093,140,,89
MT4041.2,4403249,4403467,218,,89
